Volume Tandon (L);Waktu (s);TDS Awal (ppm);TDS Akhir (ppm);Delta TDS (ppm);Rata Rata Delta TDS (ppm);
40;0;260;263;3;2,9;
40;0;263;266;3;;
40;1;266;270;4;;
40;1;270;272;2;;
40;1;272;276;4;;
40;1;276;278;2;;
40;1;278;282;4;;
40;1;282;284;2;;
40;1;284;288;4;;
40;1;288;287;1;;
40;1;287;292;5;5,9;
40;1;292;295;3;;
40;2;295;303;8;;
40;2;303;310;7;;
40;2;310;318;8;;
40;2;318;323;5;;
40;2;323;327;4;;
40;2;327;330;3;;
40;2;330;335;5;;
40;2;335;346;11;;
40;2;346;352;6;8,4;
40;2;352;363;11;;
40;3;363;371;8;;
40;3;371;380;9;;
40;3;380;382;2;;
40;3;382;396;14;;
40;3;396;405;9;;
40;3;405;412;7;;
40;3;412;421;9;;
40;3;421;430;9;;
40;3;438;445;7;10,9;
40;3;445;460;15;;
40;4;460;470;10;;
40;4;470;483;13;;
40;4;483;492;9;;
40;4;492;504;12;;
40;4;504;512;8;;
40;4;512;525;13;;
40;4;525;536;11;;
40;4;536;547;11;;
40;4;547;561;14;13;
40;4;561;575;14;;
40;5;575;585;10;;
40;5;585;599;14;;
40;5;599;614;15;;
40;5;614;627;13;;
40;5;627;640;13;;
40;5;640;652;12;;
40;5;652;664;12;;
40;5;664;677;13;;
40;5;677;693;16;15,4;
40;5;693;710;17;;
40;6;710;724;14;;
40;6;724;740;16;;
40;6;740;755;15;;
40;6;755;773;18;;
40;6;773;786;13;;
40;6;786;802;16;;
40;6;802;817;15;;
40;6;817;831;14;;
40;6;831;850;19;17,7;
40;6;850;867;17;;
40;7;867;890;23;;
40;7;890;902;12;;
40;7;902;920;18;;
40;7;920;936;16;;
40;7;936;954;18;;
40;7;954;969;15;;
40;7;969;990;21;;
40;7;990;1008;18;;
40;7;1008;1027;19;19;
40;7;1027;1045;18;;
40;8;1045;1066;21;;
40;8;1066;1084;18;;
40;8;1084;1107;23;;
40;8;1107;1123;16;;
40;8;1123;1144;21;;
40;8;1144;1162;18;;
40;8;1162;1177;15;;
40;8;1177;1198;21;;
40;8;1198;1214;16;20,3;
40;8;1214;1248;34;;
40;9;1248;1260;12;;
40;9;1260;1281;21;;
40;9;1281;1303;22;;
40;9;1303;1321;18;;
40;9;1321;1342;21;;
40;9;1342;1363;21;;
40;9;1363;1383;20;;
40;9;1383;1401;18;;
40;9;1407;1430;23;24,2;
40;9;1430;1453;23;;
40;10;1453;1476;23;;
40;10;1476;1499;23;;
40;10;1499;1522;23;;
40;10;1522;1545;23;;
40;10;1545;1566;21;;
40;10;245;273;28;;
40;10;273;301;28;;
40;10;301;328;27;;
40;10;328;359;31;29,3;
40;10;359;389;30;;
40;11;389;415;26;;
40;11;415;447;32;;
40;11;447;476;29;;
40;11;476;506;30;;
40;11;506;531;25;;
40;11;531;557;26;;
40;11;557;589;32;;
40;11;589;621;32;;
40;11;621;636;15;28,7;
40;11;636;678;42;;
40;12;678;697;19;;
40;12;697;736;39;;
40;12;736;765;29;;
40;12;765;795;30;;
40;12;795;824;29;;
40;12;824;854;30;;
40;12;854;880;26;;
40;12;880;908;28;;
40;12;908;941;33;30,4;
40;12;941;972;31;;
40;13;972;1004;32;;
40;13;1004;1033;29;;
40;13;1033;1063;30;;
40;13;1063;1092;29;;
40;13;1092;1124;32;;
40;13;1124;1154;30;;
40;13;1154;1182;28;;
40;13;1182;1212;30;;
40;13;1212;1243;31;30,7;
40;13;1243;1276;33;;
40;14;1276;1307;31;;
40;14;1307;1338;31;;
40;14;1338;1369;31;;
40;14;1369;1398;29;;
40;14;1423;1453;30;;
40;14;1453;1484;31;;
40;14;1484;1513;29;;
40;14;1513;1544;31;;
40;14;1544;1577;33;31,9;
40;14;1577;1609;32;;
40;15;1609;1641;32;;
40;15;1641;1673;32;;
40;15;1673;1704;31;;
40;15;1704;1736;32;;
40;15;1736;1771;35;;
40;15;1771;1803;32;;
40;15;1803;1832;29;;
40;15;1832;1863;31;;
40;15;1866;1899;33;40,3;
40;15;1899;1932;33;;
40;16;1932;1965;33;;
40;16;248;292;44;;
40;16;292;336;44;;
40;16;336;382;46;;
40;16;382;427;45;;
40;16;427;467;40;;
40;16;467;509;42;;
40;16;509;552;43;;
40;16;552;596;44;42,4;
40;16;596;639;43;;
40;17;639;682;43;;
40;17;682;725;43;;
40;17;725;767;42;;
40;17;767;809;42;;
40;17;809;851;42;;
40;17;851;892;41;;
40;17;892;933;41;;
40;17;933;976;43;;
40;17;976;1014;38;41,4;
40;17;1014;1061;47;;
40;18;1061;1101;40;;
40;18;1101;1143;42;;
40;18;1143;1186;43;;
40;18;1186;1224;38;;
40;18;1224;1271;47;;
40;18;1271;1310;39;;
40;18;1310;1351;41;;
40;18;1351;1390;39;;
40;18;1390;1432;42;42;
40;18;1432;1474;42;;
40;19;1474;1517;43;;
40;19;1517;1563;46;;
40;19;1563;1603;40;;
40;19;1603;1647;44;;
40;19;1647;1687;40;;
40;19;1687;1729;42;;
40;19;1729;1768;39;;
40;19;1768;1810;42;;
40;19;1810;1852;42;49,5;
40;19;1852;1893;41;;
40;20;1893;1936;43;;
40;20;250;308;58;;
40;20;308;361;53;;
40;20;361;411;50;;
40;20;411;461;50;;
40;20;461;517;56;;
40;20;517;569;52;;
40;20;569;619;50;;
40;20;241;278;37;36,5;
40;20;278;315;37;;
40;21;315;353;38;;
40;21;353;389;36;;
40;21;389;429;40;;
40;21;429;460;31;;
40;21;460;497;37;;
40;21;497;535;38;;
40;21;535;571;36;;
40;21;571;606;35;;
40;21;606;641;35;35,1;
40;21;641;678;37;;
40;22;678;714;36;;
40;22;714;750;36;;
40;22;750;785;35;;
40;22;785;820;35;;
40;22;820;854;34;;
40;22;854;889;35;;
40;22;889;923;34;;
40;22;923;957;34;;
40;22;957;992;35;33,8;
40;22;992;1028;36;;
40;23;1028;1061;33;;
40;23;1061;1097;36;;
40;23;1097;1129;32;;
40;23;1129;1163;34;;
40;23;1163;1197;34;;
40;23;1197;1229;32;;
40;23;1229;1262;33;;
40;23;1262;1295;33;;
40;23;1295;1332;37;33,4;
40;23;1332;1364;32;;
40;24;1364;1396;32;;
40;24;1396;1431;35;;
40;24;1431;1465;34;;
40;24;1465;1500;35;;
40;24;1500;1530;30;;
40;24;1530;1564;34;;
40;24;1564;1596;32;;
40;24;1596;1629;33;;
40;24;1629;1692;63;64,5;
40;24;1692;1757;65;;
40;25;1757;1822;65;;
40;25;1822;1878;56;;
40;25;1878;1944;66;;
40;25;265;332;67;;
40;25;332;397;65;;
40;25;397;462;65;;
40;25;462;528;66;;
40;25;528;595;67;;
40;25;595;662;67;67,6;
40;25;662;729;67;;
40;26;729;797;68;;
40;26;797;866;69;;
40;26;866;933;67;;
40;26;933;1001;68;;
40;26;1001;1068;67;;
40;26;1068;1136;68;;
40;26;1136;1204;68;;
40;26;1204;1271;67;;
40;26;1271;1341;70;70,5;0
40;26;1341;1410;69;;
40;27;1410;1483;73;;
40;27;1483;1554;71;;
40;27;1554;1626;72;;
40;27;1626;1696;70;;
40;27;1696;1767;71;;
40;27;1767;1836;69;;
40;27;1836;1906;70;;
40;27;1906;1976;70;;
40;27;276;349;73;73,8;0
40;27;349;427;78;;
40;28;427;501;74;;
40;28;501;575;74;;
40;28;575;650;75;;
40;28;650;724;74;;
40;28;724;797;73;;
40;28;797;869;72;;
40;28;869;942;73;;
40;28;942;1014;72;;
40;28;1014;1089;75;77,6;0
40;28;1089;1165;76;;
40;29;1165;1243;78;;
40;29;1243;1322;79;;
40;29;1322;1400;78;;
40;29;1400;1478;78;;
40;29;1478;1557;79;;
40;29;1557;1635;78;;
40;29;1635;1714;79;;
40;29;1714;1790;76;;
40;29;1790;1871;81;81,9;0
40;29;1871;1953;82;;
40;30;256;341;85;;
40;30;341;424;83;;
40;30;424;506;82;;
40;30;506;589;83;;
40;30;589;671;82;;
40;30;671;752;81;;
40;30;752;832;80;;
40;30;832;912;80;;
40;30;253;349;96;86;0
40;30;349;443;94;;
40;31;443;524;81;;
40;31;524;608;84;;
40;31;608;688;80;;
40;31;688;771;83;;
40;31;771;854;83;;
40;31;854;940;86;;
40;31;940;1028;88;;
40;31;1028;1113;85;;
40;31;1113;1196;83;87,4;0
40;31;1196;1282;86;;
40;32;1282;1372;90;;
40;32;1372;1456;84;;
40;32;1456;1546;90;;
40;32;1546;1631;85;;
40;32;1631;1717;86;;
40;32;1717;1807;90;;
40;32;1807;1898;91;;
40;32;1898;1987;89;;
40;32;268;361;93;91,2;0
40;32;361;447;86;;
40;33;447;540;93;;
40;33;540;635;95;;
40;33;635;722;87;;
40;33;722;813;91;;
40;33;813;906;93;;
40;33;906;996;90;;
40;33;996;1090;94;;
40;33;1090;1180;90;;
40;33;1180;1270;90;94;0
40;33;1270;1367;97;;
40;34;1367;1458;91;;
40;34;1458;1548;90;;
40;34;1548;1639;91;;
40;34;1639;1737;98;;
40;34;1737;1833;96;;
40;34;1833;1928;95;;
40;34;276;370;94;;
40;34;370;468;98;;
40;34;468;568;100;98,1;0
40;34;568;668;100;;
40;35;668;769;101;;
40;35;769;868;99;;
40;35;868;966;98;;
40;35;966;1058;92;;
40;35;1058;1157;99;;
40;35;1157;1253;96;;
40;35;1253;1348;95;;
40;35;1348;1449;101;;
40;35;1449;1551;102;101,6;0
40;35;1551;1655;104;;
40;36;1655;1752;97;;
40;36;1752;1857;105;;
40;36;1857;1956;99;;
40;36;269;374;105;;
40;36;374;473;99;;
40;36;473;572;99;;
40;36;572;674;102;;
40;36;674;778;104;;
40;36;778;883;105;103,5;0
40;36;883;986;103;;
40;37;986;1091;105;;
40;37;1091;1193;102;;
40;37;1193;1300;107;;
40;37;1300;1402;102;;
40;37;1402;1502;100;;
40;37;1502;1604;102;;
40;37;1604;1708;104;;
40;37;1708;1813;105;;
40;37;1813;1916;103;105,6;0
40;37;289;394;105;;
40;38;394;497;103;;
40;38;497;607;110;;
40;38;607;713;106;;
40;38;713;816;103;;
40;38;816;920;104;;
40;38;920;1028;108;;
40;38;1028;1139;111;;
40;38;1139;1242;103;;
40;38;1242;1351;109;108,5;0
40;38;1351;1457;106;;
40;39;1457;1568;111;;
40;39;1568;1672;104;;
40;39;1672;1780;108;;
40;39;1780;1891;111;;
40;39;301;413;112;;
40;39;413;521;108;;
40;39;521;627;106;;
40;39;627;737;110;;
40;39;737;851;114;111,4;0
40;39;851;967;116;;
40;40;967;1076;109;;
40;40;1076;1186;110;;
40;40;1186;1295;109;;
40;40;1295;1409;114;;
40;40;1409;1516;107;;
40;40;1516;1623;107;;
40;40;1623;1739;116;;
40;40;1739;1851;112;;
40;40;1851;1968;117;115,4;
40;40;256;368;112;;
40;41;368;478;110;;
40;41;478;596;118;;
40;41;596;711;115;;
40;41;711;822;111;;
40;41;822;941;119;;
40;41;941;1059;118;;
40;41;1059;1174;115;;
40;41;1174;1293;119;;
40;41;1293;1407;114;119;
40;41;1407;1521;114;;
40;42;1521;1643;122;;
40;42;1643;1763;120;;
40;42;1763;1881;118;;
40;42;290;413;123;;
40;42;413;528;115;;
40;42;528;650;122;;
40;42;650;773;123;;
40;42;773;892;119;;
40;42;892;1010;118;120,8;
40;42;1010;1128;118;;
40;43;1128;1250;122;;
40;43;1250;1374;124;;
40;43;1374;1494;120;;
40;43;1494;1613;119;;
40;43;1613;1735;122;;
40;43;1735;1860;125;;
40;43;1860;1979;119;;
40;43;298;419;121;;
40;43;419;541;122;123,1;
40;43;541;669;128;;
40;44;669;788;119;;
40;44;788;915;127;;
40;44;915;1036;121;;
40;44;1036;1155;119;;
40;44;1155;1278;123;;
40;44;1278;1397;119;;
40;44;1397;1522;125;;
40;44;1522;1650;128;;
40;44;1650;1772;122;126,5;
40;44;1772;1902;130;;
40;45;272;402;130;;
40;45;402;527;125;;
40;45;527;653;126;;
40;45;653;779;126;;
40;45;779;905;126;;
40;45;905;1032;127;;
40;45;1032;1156;124;;
40;45;1156;1285;129;;
40;45;1285;1419;134;128,2;
40;45;1419;1549;130;;
40;46;1549;1675;126;;
40;46;1675;1803;128;;
40;46;1803;1929;126;;
40;46;267;393;126;;
40;46;393;521;128;;
40;46;521;648;127;;
40;46;648;774;126;;
40;46;774;905;131;;
40;46;905;1031;126;131,2;
40;46;1031;1165;134;;
40;47;1165;1300;135;;
40;47;1300;1428;128;;
40;47;1428;1558;130;;
40;47;1558;1692;134;;
40;47;1692;1826;134;;
40;47;1826;1952;126;;
40;47;289;424;135;;
40;47;424;554;130;;
40;47;554;691;137;133,4;
40;47;691;823;132;;
40;48;823;960;137;;
40;48;960;1091;131;;
40;48;1091;1221;130;;
40;48;1221;1358;137;;
40;48;1358;1490;132;;
40;48;1490;1620;130;;
40;48;1620;1752;132;;
40;48;1752;1888;136;;
40;48;265;405;140;136,8;
40;48;405;544;139;;
40;49;544;677;133;;
40;49;677;817;140;;
40;49;817;957;140;;
40;49;957;1092;135;;
40;49;1092;1226;134;;
40;49;1226;1364;138;;
40;49;1364;1498;134;;
40;49;1498;1633;135;;
40;49;1633;1777;144;139,5;
40;49;1777;1918;141;;
40;50;256;393;137;;
40;50;393;529;136;;
40;50;529;671;142;;
40;50;671;807;136;;
40;50;807;947;140;;
40;50;947;1089;142;;
40;50;1089;1225;136;;
40;50;1225;1366;141;;
40;50;1366;1504;138;140,8;
40;50;1504;1651;147;;
40;51;1651;1792;141;;
40;51;1792;1933;141;;
40;51;245;386;141;;
40;51;386;526;140;;
40;51;526;668;142;;
40;51;668;807;139;;
40;51;807;947;140;;
40;51;947;1086;139;;
40;51;1086;1226;140;142,7;
40;51;1226;1372;146;;
40;52;1372;1513;141;;
40;52;1513;1653;140;;
40;52;1653;1800;147;;
40;52;1800;1939;139;;
40;52;256;400;144;;
40;52;400;541;141;;
40;52;541;689;148;;
40;52;689;830;141;;
40;52;830;972;142;143,5;
40;52;972;1113;141;;
40;53;1113;1261;148;;
40;53;1261;1403;142;;
40;53;1403;1544;141;;
40;53;1544;1688;144;;
40;53;1688;1829;141;;
40;53;1829;1975;146;;
40;53;278;420;142;;
40;53;420;568;148;;
40;53;568;717;149;147,5;
40;53;717;860;143;;
40;54;860;1006;146;;
40;54;1006;1150;144;;
40;54;1150;1301;151;;
40;54;1301;1452;151;;
40;54;1452;1602;150;;
40;54;1602;1751;149;;
40;54;1751;1900;149;;
40;54;298;441;143;;
40;54;441;589;148;149,6;
40;54;589;741;152;;
40;55;741;887;146;;
40;55;887;1039;152;;
40;55;1039;1190;151;;
40;55;1190;1344;154;;
40;55;1344;1490;146;;
40;55;1490;1642;152;;
40;55;1642;1791;149;;
40;55;1791;1937;146;;
40;55;267;417;150;151,5;
40;55;417;571;154;;
40;56;571;724;153;;
40;56;724;873;149;;
40;56;873;1028;155;;
40;56;1028;1184;156;;
40;56;1184;1332;148;;
40;56;1332;1480;148;;
40;56;1480;1628;148;;
40;56;1628;1782;154;;
40;56;1782;1940;158;156,3;
40;56;299;458;159;;
40;57;458;615;157;;
40;57;615;769;154;;
40;57;769;925;156;;
40;57;925;1081;156;;
40;57;1081;1237;156;;
40;57;1237;1393;156;;
40;57;1393;1551;158;;
40;57;1551;1704;153;;
40;57;1704;1864;160;159,8;
40;57;245;402;157;;
40;58;402;566;164;;
40;58;566;724;158;;
40;58;724;878;154;;
40;58;878;1034;156;;
40;58;1034;1196;162;;
40;58;1196;1359;163;;
40;58;1359;1521;162;;
40;58;1521;1683;162;;
40;58;1683;1848;165;162,4;
40;58;265;428;163;;
40;59;428;590;162;;
40;59;590;750;160;;
40;59;750;914;164;;
40;59;914;1079;165;;
40;59;1079;1245;166;;
40;59;1245;1405;160;;
40;59;1405;1566;161;;
40;59;1566;1724;158;;
40;59;1724;1894;170;166,3;
40;59;276;440;164;;
40;60;440;604;164;;
40;60;604;771;167;;
40;60;771;941;170;;
40;60;941;1110;169;;
40;60;1110;1276;166;;
40;60;1276;1439;163;;
40;60;1439;1604;165;;
40;60;1604;1769;165;;
50;1;244;244;0;1,6;
50;1;244;247;3;;
50;1;247;248;1;;
50;1;248;249;1;;
50;1;249;251;2;;
50;1;251;253;2;;
50;1;253;255;2;;
50;1;255;257;2;;
50;1;257;259;2;;
50;1;259;260;1;;
50;2;262;264;2;3,2;
50;2;264;268;4;;
50;2;268;271;3;;
50;2;271;275;4;;
50;2;275;279;4;;
50;2;279;282;3;;
50;2;282;284;2;;
50;2;284;288;4;;
50;2;288;291;3;;
50;2;291;294;3;;
50;3;297;302;5;4,9;
50;3;302;306;4;;
50;3;306;311;5;;
50;3;311;316;5;;
50;3;316;320;4;;
50;3;320;326;6;;
50;3;326;331;5;;
50;3;331;335;4;;
50;3;335;341;6;;
50;3;341;346;5;;
50;4;346;352;6;6,3;
50;4;352;359;7;;
50;4;359;365;6;;
50;4;365;371;6;;
50;4;371;377;6;;
50;4;377;384;7;;
50;4;384;390;6;;
50;4;390;397;7;;
50;4;397;403;6;;
50;4;403;409;6;;
50;5;409;417;8;7,7;
50;5;417;425;8;;
50;5;425;432;7;;
50;5;432;439;7;;
50;5;439;448;9;;
50;5;448;457;9;;
50;5;457;464;7;;
50;5;464;472;8;;
50;5;472;479;7;;
50;5;501;508;7;;
50;6;508;514;6;9,6;
50;6;514;528;14;;
50;6;528;538;10;;
50;6;538;548;10;;
50;6;548;559;11;;
50;6;559;569;10;;
50;6;569;578;9;;
50;6;578;586;8;;
50;6;586;595;9;;
50;6;595;604;9;;
50;7;604;618;14;11,7;
50;7;618;628;10;;
50;7;628;644;16;;
50;7;644;656;12;;
50;7;656;667;11;;
50;7;667;677;10;;
50;7;677;688;11;;
50;7;688;700;12;;
50;7;700;711;11;;
50;7;711;721;10;;
50;8;721;734;13;13,1;
50;8;734;747;13;;
50;8;747;763;16;;
50;8;763;776;13;;
50;8;776;790;14;;
50;8;790;803;13;;
50;8;803;815;12;;
50;8;815;828;13;;
50;8;828;839;11;;
50;8;839;852;13;;
50;9;852;866;14;14,3;
50;9;866;881;15;;
50;9;881;894;13;;
50;9;894;908;14;;
50;9;908;923;15;;
50;9;923;938;15;;
50;9;938;954;16;;
50;9;954;968;14;;
50;9;968;981;13;;
50;9;981;995;14;;
50;10;995;1011;16;16;
50;10;1011;1028;17;;
50;10;1028;1043;15;;
50;10;1043;1059;16;;
50;10;1059;1076;17;;
50;10;1076;1092;16;;
50;10;1092;1107;15;;
50;10;1107;1122;15;;
50;10;1122;1138;16;;
50;10;1138;1155;17;;
50;11;1155;1172;17;17,9;
50;11;1172;1191;19;;
50;11;1191;1211;20;;
50;11;1211;1229;18;;
50;11;1229;1247;18;;
50;11;1247;1264;17;;
50;11;1264;1280;16;;
50;11;1280;1298;18;;
50;11;1298;1317;19;;
50;11;1317;1334;17;;
50;12;1334;1355;21;19,8;
50;12;1355;1375;20;;
50;12;1375;1398;23;;
50;12;1398;1418;20;;
50;12;1418;1437;19;;
50;12;1437;1455;18;;
50;12;1455;1474;19;;
50;12;1474;1494;20;;
50;12;1494;1513;19;;
50;12;1513;1532;19;;
50;13;1532;1553;21;21,6;
50;13;1553;1578;25;;
50;13;1578;1598;20;;
50;13;1598;1621;23;;
50;13;1621;1641;20;;
50;13;1641;1664;23;;
50;13;1664;1686;22;;
50;13;1686;1707;21;;
50;13;1707;1728;21;;
50;13;1728;1748;20;;
50;14;1748;1771;23;23,2;
50;14;1771;1798;27;;
50;14;1798;1820;22;;
50;14;1820;1840;20;;
50;14;1840;1863;23;;
50;14;1863;1887;24;;
50;14;1887;1910;23;;
50;14;1910;1934;24;;
50;14;1934;1957;23;;
50;14;1957;1980;23;;
50;15;265;290;25;24,3;
50;15;290;312;22;;
50;15;312;336;24;;
50;15;336;361;25;;
50;15;361;387;26;;
50;15;387;412;25;;
50;15;412;436;24;;
50;15;436;461;25;;
50;15;461;485;24;;
50;15;485;508;23;;
50;16;508;533;25;25,4;
50;16;533;558;25;;
50;16;558;584;26;;
50;16;584;611;27;;
50;16;611;636;25;;
50;16;636;660;24;;
50;16;660;685;25;;
50;16;685;711;26;;
50;16;711;736;25;;
50;16;736;762;26;;
50;17;762;789;27;27,8;
50;17;789;817;28;;
50;17;817;846;29;;
50;17;846;873;27;;
50;17;873;900;27;;
50;17;900;928;28;;
50;17;928;956;28;;
50;17;956;985;29;;
50;17;985;1012;27;;
50;17;1012;1040;28;;
50;18;1040;1072;32;30,3;
50;18;1072;1105;33;;
50;18;1105;1137;32;;
50;18;1137;1167;30;;
50;18;1167;1198;31;;
50;18;1198;1227;29;;
50;18;1227;1257;30;;
50;18;1257;1286;29;;
50;18;1286;1314;28;;
50;18;1314;1343;29;;
50;19;1343;1376;33;32,1;
50;19;1376;1408;32;;
50;19;1408;1441;33;;
50;19;1441;1472;31;;
50;19;1472;1504;32;;
50;19;1504;1537;33;;
50;19;1537;1569;32;;
50;19;1569;1600;31;;
50;19;1600;1632;32;;
50;19;1632;1664;32;;
50;20;1664;1697;33;33,1;
50;20;1697;1728;31;;
50;20;1728;1760;32;;
50;20;1760;1794;34;;
50;20;1794;1829;35;;
50;20;1829;1862;33;;
50;20;1862;1896;34;;
50;20;1896;1928;32;;
50;20;1928;1961;33;;
50;20;1961;1995;34;;
50;21;245;279;34;34,7;
50;21;279;312;33;;
50;21;312;347;35;;
50;21;347;383;36;;
50;21;383;418;35;;
50;21;418;452;34;;
50;21;452;487;35;;
50;21;487;523;36;;
50;21;523;558;35;;
50;21;558;592;34;;
50;22;592;627;35;35,8;
50;22;627;660;33;;
50;22;660;695;35;;
50;22;695;731;36;;
50;22;731;766;35;;
50;22;766;802;36;;
50;22;802;839;37;;
50;22;839;875;36;;
50;22;875;912;37;;
50;22;912;950;38;;
50;23;950;987;37;37,4;
50;23;987;1024;37;;
50;23;1024;1062;38;;
50;23;1062;1099;37;;
50;23;1099;1135;36;;
50;23;1135;1172;37;;
50;23;1172;1210;38;;
50;23;1210;1249;39;;
50;23;1249;1287;38;;
50;23;1287;1324;37;;
50;24;1324;1363;39;38,9;
50;24;1363;1403;40;;
50;24;1403;1442;39;;
50;24;1442;1480;38;;
50;24;1480;1519;39;;
50;24;1519;1558;39;;
50;24;1558;1596;38;;
50;24;1596;1635;39;;
50;24;1635;1674;39;;
50;24;1674;1713;39;;
50;25;1713;1753;40;40;
50;25;1753;1794;41;;
50;25;1794;1836;42;;
50;25;1836;1876;40;;
50;25;1876;1915;39;;
50;25;1915;1954;39;;
50;25;1954;1992;38;;
50;25;276;316;40;;
50;25;316;356;40;;
50;25;356;397;41;;
50;26;397;438;41;41,5;
50;26;438;480;42;;
50;26;480;523;43;;
50;26;523;563;40;;
50;26;563;604;41;;
50;26;604;646;42;;
50;26;646;689;43;;
50;26;689;731;42;;
50;26;731;772;41;;
50;26;772;812;40;;
50;27;812;860;48;45;
50;27;860;904;44;;
50;27;904;954;50;;
50;27;954;999;45;;
50;27;999;1043;44;;
50;27;1043;1086;43;;
50;27;1086;1130;44;;
50;27;1130;1175;45;;
50;27;1175;1219;44;;
50;27;1219;1262;43;;
50;28;1262;1311;49;48,4;
50;28;1311;1359;48;;
50;28;1359;1409;50;;
50;28;1409;1458;49;;
50;28;1458;1506;48;;
50;28;1506;1553;47;;
50;28;1553;1602;49;;
50;28;1602;1650;48;;
50;28;1650;1699;49;;
50;28;1699;1746;47;;
50;29;1746;1796;50;50,2;
50;29;1796;1847;51;;
50;29;1847;1899;52;;
50;29;1899;1949;50;;
50;29;260;311;51;;
50;29;311;360;49;;
50;29;360;410;50;;
50;29;410;460;50;;
50;29;460;510;50;;
50;29;510;559;49;;
50;30;559;610;51;51,9;
50;30;610;662;52;;
50;30;662;715;53;;
50;30;715;767;52;;
50;30;767;819;52;;
50;30;819;870;51;;
50;30;870;922;52;;
50;30;922;973;51;;
50;30;973;1026;53;;
50;30;1026;1078;52;;
50;31;258;324;66;55,5;49,6
50;31;324;382;58;;
50;31;382;439;57;;
50;31;439;493;54;;
50;31;493;548;55;;
50;31;548;599;51;;
50;31;599;656;57;;
50;31;656;708;52;;
50;31;708;757;49;;
50;31;757;813;56;;
50;32;813;872;59;57,5;51,2
50;32;872;929;57;;
50;32;929;988;59;;
50;32;988;1048;60;;
50;32;1048;1108;60;;
50;32;1108;1167;59;;
50;32;1167;1218;51;;
50;32;1218;1270;52;;
50;32;1270;1327;57;;
50;32;1327;1388;61;;
50;33;1388;1449;61;60,2;52,8
50;33;1449;1508;59;;
50;33;1508;1565;57;;
50;33;1565;1625;60;;
50;33;1625;1685;60;;
50;33;1685;1745;60;;
50;33;1745;1807;62;;
50;33;1807;1869;62;;
50;33;1869;1932;63;;
50;33;1932;1990;58;;
50;34;291;352;61;61,1;54,4
50;34;352;413;61;;
50;34;413;476;63;;
50;34;476;538;62;;
50;34;538;596;58;;
50;34;596;657;61;;
50;34;657;714;57;;
50;34;714;778;64;;
50;34;778;844;66;;
50;34;844;902;58;;
50;35;902;962;60;62,2;54,4
50;35;962;1023;61;;
50;35;1023;1082;59;;
50;35;1082;1149;67;;
50;35;1149;1207;58;;
50;35;1207;1273;66;;
50;35;1273;1339;66;;
50;35;1339;1402;63;;
50;35;1402;1465;63;;
50;35;1465;1524;59;;
50;36;1524;1584;60;62,8;56
50;36;1584;1643;59;;
50;36;1643;1707;64;;
50;36;1707;1772;65;;
50;36;1772;1832;60;;
50;36;1832;1899;67;;
50;36;1899;1961;62;;
50;36;267;327;60;;
50;36;327;391;64;;
50;36;391;458;67;;
50;37;458;520;62;64,3;59,2
50;37;520;586;66;;
50;37;586;646;60;;
50;37;646;712;66;;
50;37;712;772;60;;
50;37;772;837;65;;
50;37;837;906;69;;
50;37;906;969;63;;
50;37;969;1034;65;;
50;37;1034;1101;67;;
50;38;1101;1168;67;64,6;
50;38;1168;1235;67;;
50;38;1235;1298;63;;
50;38;1298;1359;61;;
50;38;1359;1420;61;;
50;38;1420;1489;69;;
50;38;1489;1550;61;;
50;38;1550;1616;66;;
50;38;1616;1686;70;;
50;38;1686;1747;61;;
50;39;1747;1813;66;66,1;
50;39;1813;1876;63;;
50;39;1876;1946;70;;
50;39;278;347;69;;
50;39;347;412;65;;
50;39;412;476;64;;
50;39;476;544;68;;
50;39;544;614;70;;
50;39;614;677;63;;
50;39;677;740;63;;
50;40;740;805;65;65,7;
50;40;805;869;64;;
50;40;869;937;68;;
50;40;937;1006;69;;
50;40;1006;1069;63;;
50;40;1069;1135;66;;
50;40;1135;1200;65;;
50;40;1200;1263;63;;
50;40;1263;1334;71;;
50;40;1334;1397;63;;
50;41;1397;1461;64;67,6;
50;41;1461;1526;65;;
50;41;1526;1590;64;;
50;41;1590;1662;72;;
50;41;1662;1732;70;;
50;41;1732;1803;71;;
50;41;1803;1868;65;;
50;41;1868;1934;66;;
50;41;256;323;67;;
50;41;323;395;72;;
50;42;395;465;70;69,2;
50;42;465;535;70;;
50;42;535;604;69;;
50;42;604;677;73;;
50;42;677;749;72;;
50;42;749;816;67;;
50;42;816;887;71;;
50;42;887;952;65;;
50;42;952;1022;70;;
50;42;1022;1087;65;;
50;43;1087;1157;70;71;
50;43;1157;1226;69;;
50;43;1226;1296;70;;
50;43;1296;1367;71;;
50;43;1367;1439;72;;
50;43;1439;1512;73;;
50;43;1512;1585;73;;
50;43;1585;1655;70;;
50;43;1655;1725;70;;
50;43;1725;1797;72;;
50;44;1797;1865;68;73,2;
50;44;1865;1935;70;;
50;44;289;362;73;;
50;44;362;436;74;;
50;44;436;513;77;;
50;44;513;582;69;;
50;44;582;659;77;;
50;44;659;733;74;;
50;44;733;808;75;;
50;44;808;883;75;;
50;45;883;962;79;75,3;
50;45;962;1032;70;;
50;45;1032;1111;79;;
50;45;1111;1182;71;;
50;45;1182;1260;78;;
50;45;1260;1332;72;;
50;45;1332;1409;77;;
50;45;1409;1483;74;;
50;45;1483;1557;74;;
50;45;1557;1636;79;;
50;46;1636;1716;80;75;
50;46;1716;1790;74;;
50;46;1790;1865;75;;
50;46;1865;1937;72;;
50;46;256;334;78;;
50;46;334;411;77;;
50;46;411;486;75;;
50;46;486;559;73;;
50;46;559;631;72;;
50;46;631;705;74;;
50;47;705;782;77;77;
50;47;782;855;73;;
50;47;855;936;81;;
50;47;936;1016;80;;
50;47;1016;1092;76;;
50;47;1092;1167;75;;
50;47;1167;1245;78;;
50;47;1245;1322;77;;
50;47;1322;1398;76;;
50;47;1398;1475;77;;
50;48;1475;1557;82;79,4;
50;48;1557;1636;79;;
50;48;1636;1713;77;;
50;48;1713;1791;78;;
50;48;1791;1873;82;;
50;48;1873;1956;83;;
50;48;301;382;81;;
50;48;382;461;79;;
50;48;461;538;77;;
50;48;538;614;76;;
50;49;614;692;78;80,4;
50;49;692;773;81;;
50;49;773;856;83;;
50;49;856;939;83;;
50;49;939;1015;76;;
50;49;1015;1101;86;;
50;49;1101;1181;80;;
50;49;1181;1259;78;;
50;49;1259;1340;81;;
50;49;1340;1418;78;;
50;50;1418;1503;85;82,5;
50;50;1503;1581;78;;
50;50;1581;1661;80;;
50;50;1661;1746;85;;
50;50;1746;1831;85;;
50;50;1831;1915;84;;
50;50;289;375;86;;
50;50;375;459;84;;
50;50;459;537;78;;
50;50;537;617;80;;
50;51;617;698;81;83,8;
50;51;698;783;85;;
50;51;783;868;85;;
50;51;868;954;86;;
50;51;954;1037;83;;
50;51;1037;1118;81;;
50;51;1118;1204;86;;
50;51;1204;1287;83;;
50;51;1287;1372;85;;
50;51;1372;1455;83;;
50;52;1455;1545;90;83,6;
50;52;1545;1629;84;;
50;52;1629;1710;81;;
50;52;1710;1792;82;;
50;52;1792;1877;85;;
50;52;1877;1958;81;;
50;52;278;359;81;;
50;52;359;444;85;;
50;52;444;525;81;;
50;52;525;611;86;;
50;53;611;699;88;85;
50;53;699;788;89;;
50;53;788;876;88;;
50;53;876;961;85;;
50;53;961;1043;82;;
50;53;1043;1125;82;;
50;53;1125;1209;84;;
50;53;1209;1292;83;;
50;53;1292;1377;85;;
50;53;1377;1461;84;;
50;54;1461;1548;87;86,7;
50;54;1548;1634;86;;
50;54;1634;1724;90;;
50;54;1724;1808;84;;
50;54;1808;1898;90;;
50;54;1898;1981;83;;
50;54;267;357;90;;
50;54;357;439;82;;
50;54;439;527;88;;
50;54;527;614;87;;
50;55;614;702;88;85,6;
50;55;702;786;84;;
50;55;786;871;85;;
50;55;871;956;85;;
50;55;956;1042;86;;
50;55;1042;1131;89;;
50;55;1131;1216;85;;
50;55;1216;1300;84;;
50;55;1300;1384;84;;
50;55;1384;1470;86;;
50;56;1470;1556;86;88,3;
50;56;1556;1648;92;;
50;56;1648;1737;89;;
50;56;1737;1825;88;;
50;56;1825;1910;85;;
50;56;1910;1998;88;;
50;56;250;340;90;;
50;56;340;431;91;;
50;56;431;522;91;;
50;56;522;605;83;;
50;57;605;697;92;90,6;
50;57;697;790;93;;
50;57;790;876;86;;
50;57;876;968;92;;
50;57;968;1056;88;;
50;57;1056;1148;92;;
50;57;1148;1233;85;;
50;57;1233;1323;90;;
50;57;1323;1417;94;;
50;57;1417;1511;94;;
50;58;1511;1599;88;91,4;
50;58;1599;1696;97;;
50;58;1696;1787;91;;
50;58;1787;1875;88;;
50;58;1875;1965;90;;
50;58;256;349;93;;
50;58;349;442;93;;
50;58;442;532;90;;
50;58;532;623;91;;
50;58;623;716;93;;
50;59;716;813;97;92,4;
50;59;813;905;92;;
50;59;905;996;91;;
50;59;996;1085;89;;
50;59;1085;1174;89;;
50;59;1174;1264;90;;
50;59;1264;1362;98;;
50;59;1362;1452;90;;
50;59;1452;1549;97;;
50;59;1549;1640;91;;
50;60;1640;1730;90;94,2;
50;60;1730;1829;99;;
50;60;1829;1923;94;;
50;60;320;411;91;;
50;60;411;510;99;;
50;60;510;608;98;;
50;60;608;697;89;;
50;60;697;788;91;;
50;60;788;881;93;;
50;60;881;979;98;;
60;1;1286;1291;5;1,5;
60;1;1291;1289;2;;
60;1;1289;1290;1;;
60;1;1290;1291;1;;
60;1;1291;1292;1;;
60;1;1292;1293;1;;
60;1;1293;1294;1;;
60;1;1294;1295;1;;
60;1;1295;1296;1;;
60;1;1296;1297;1;;
60;2;1297;1299;2;2;
60;2;1299;1301;2;;
60;2;1301;1303;2;;
60;2;1303;1305;2;;
60;2;1305;1307;2;;
60;2;1307;1309;2;;
60;2;1309;1311;2;;
60;2;1311;1313;2;;
60;2;1313;1315;2;;
60;2;1315;1317;2;;
60;3;1317;1320;3;3;
60;3;1320;1323;3;;
60;3;1323;1326;3;;
60;3;1326;1329;3;;
60;3;1329;1332;3;;
60;3;1332;1335;3;;
60;3;1335;1338;3;;
60;3;1338;1341;3;;
60;3;1341;1344;3;;
60;3;1344;1347;3;;
60;4;1347;1353;6;4;
60;4;1353;1355;2;;
60;4;1355;1359;4;;
60;4;1359;1363;4;;
60;4;1363;1367;4;;
60;4;1367;1371;4;;
60;4;1371;1375;4;;
60;4;1375;1379;4;;
60;4;1379;1383;4;;
60;4;1383;1387;4;;
60;5;1387;1392;5;4,9;
60;5;1392;1397;5;;
60;5;1397;1402;5;;
60;5;1402;1407;5;;
60;5;1407;1412;5;;
60;5;1412;1417;5;;
60;5;1417;1422;5;;
60;5;1422;1426;4;;
60;5;1426;1431;5;;
60;5;1431;1436;5;;
60;6;1436;1441;5;6,3;
60;6;1441;1449;8;;
60;6;1449;1456;7;;
60;6;1456;1461;5;;
60;6;1461;1467;6;;
60;6;1467;1473;6;;
60;6;1473;1480;7;;
60;6;1480;1486;6;;
60;6;1486;1493;7;;
60;6;1493;1499;6;;
60;7;1499;1509;10;7,9;
60;7;1509;1518;9;;
60;7;1518;1527;9;;
60;7;1527;1535;8;;
60;7;1535;1542;7;;
60;7;1542;1548;6;;
60;7;1548;1555;7;;
60;7;1555;1563;8;;
60;7;1563;1571;8;;
60;7;1571;1578;7;;
60;8;1578;1587;9;9,2;
60;8;1587;1599;12;;
60;8;1599;1607;8;;
60;8;1607;1616;9;;
60;8;1616;1625;9;;
60;8;1625;1635;10;;
60;8;1635;1644;9;;
60;8;1644;1653;9;;
60;8;1653;1662;9;;
60;8;1662;1670;8;;
60;9;1670;1680;10;10,9;
60;9;1680;1690;10;;
60;9;1690;1704;14;;
60;9;1704;1715;11;;
60;9;1715;1727;12;;
60;9;1727;1736;9;;
60;9;1736;1748;12;;
60;9;1748;1759;11;;
60;9;1759;1769;10;;
60;9;1769;1779;10;;
60;10;1779;1789;10;12,4;
60;10;1789;1804;15;;
60;10;1804;1817;13;;
60;10;1817;1829;12;;
60;10;1829;1842;13;;
60;10;1842;1854;12;;
60;10;1854;1867;13;;
60;10;1867;1879;12;;
60;10;1879;1891;12;;
60;10;1891;1903;12;;
60;11;1903;1919;16;13,8;
60;11;1919;1933;14;;
60;11;1933;1947;14;;
60;11;1947;1960;13;;
60;11;1960;1974;14;;
60;11;1974;1987;13;;
60;11;276;289;13;;
60;11;289;301;12;;
60;11;301;316;15;;
60;11;316;330;14;;
60;12;330;348;18;15,8;
60;12;348;363;15;;
60;12;363;378;15;;
60;12;378;393;15;;
60;12;393;409;16;;
60;12;409;424;15;;
60;12;424;440;16;;
60;12;440;457;17;;
60;12;457;473;16;;
60;12;473;488;15;;
60;13;488;505;17;17,8;
60;13;505;522;17;;
60;13;522;539;17;;
60;13;539;556;17;;
60;13;556;575;19;;
60;13;575;593;18;;
60;13;593;612;19;;
60;13;612;629;17;;
60;13;629;647;18;;
60;13;647;666;19;;
60;14;666;680;14;18,6;
60;14;680;698;18;;
60;14;698;716;18;;
60;14;716;735;19;;
60;14;735;753;18;;
60;14;753;773;20;;
60;14;773;792;19;;
60;14;792;813;21;;
60;14;813;833;20;;
60;14;833;852;19;;
60;15;852;872;20;20,9;
60;15;872;895;23;;
60;15;895;916;21;;
60;15;916;936;20;;
60;15;936;958;22;;
60;15;958;979;21;;
60;15;979;999;20;;
60;15;999;1020;21;;
60;15;1020;1040;20;;
60;15;1040;1061;21;;
60;16;1061;1083;22;23,8;
60;16;1083;1106;23;;
60;16;1106;1129;23;;
60;16;1129;1153;24;;
60;16;1153;1177;24;;
60;16;1177;1202;25;;
60;16;1202;1225;23;;
60;16;1225;1249;24;;
60;16;1249;1274;25;;
60;16;1274;1299;25;;
60;17;1299;1328;29;25,7;
60;17;1328;1353;25;;
60;17;1353;1380;27;;
60;17;1380;1404;24;;
60;17;1404;1430;26;;
60;17;1430;1455;25;;
60;17;1455;1481;26;;
60;17;1481;1505;24;;
60;17;1505;1531;26;;
60;17;1531;1556;25;;
60;18;1556;1584;28;28;
60;18;1584;1613;29;;
60;18;1613;1640;27;;
60;18;1640;1668;28;;
60;18;1668;1697;29;;
60;18;1697;1725;28;;
60;18;1725;1752;27;;
60;18;1752;1781;29;;
60;18;1781;1809;28;;
60;18;1809;1836;27;;
60;19;1836;1865;29;29,4;
60;19;1865;1893;28;;
60;19;1893;1923;30;;
60;19;1923;1952;29;;
60;19;1952;1982;30;;
60;19;275;306;31;;
60;19;306;334;28;;
60;19;334;364;30;;
60;19;364;393;29;;
60;19;393;423;30;;
60;20;423;456;33;30,8;
60;20;456;485;29;;
60;20;485;519;34;;
60;20;519;549;30;;
60;20;549;578;29;;
60;20;578;608;30;;
60;20;608;636;28;;
60;20;636;668;32;;
60;20;668;701;33;;
60;20;701;731;30;;
60;21;731;765;34;33;
60;21;765;798;33;;
60;21;798;831;33;;
60;21;831;865;34;;
60;21;865;900;35;;
60;21;900;934;34;;
60;21;934;966;32;;
60;21;966;999;33;;
60;21;999;1031;32;;
60;21;1031;1061;30;;
60;22;1061;1095;34;36,4;
60;22;1095;1130;35;;
60;22;1130;1164;34;;
60;22;1164;1199;35;;
60;22;1199;1235;36;;
60;22;1235;1272;37;;
60;22;1272;1310;38;;
60;22;1310;1349;39;;
60;22;1349;1387;38;;
60;22;1387;1425;38;;
60;23;1425;1460;35;37,1;
60;23;1460;1495;35;;
60;23;1495;1532;37;;
60;23;1532;1570;38;;
60;23;1570;1609;39;;
60;23;1609;1646;37;;
60;23;1646;1682;36;;
60;23;1682;1720;38;;
60;23;1720;1757;37;;
60;23;1757;1796;39;;
60;24;1796;1836;40;39,2;
60;24;1836;1877;41;;
60;24;1877;1920;43;;
60;24;1920;1958;38;;
60;24;1958;1997;39;;
60;24;260;298;38;;
60;24;298;337;39;;
60;24;337;375;38;;
60;24;375;412;37;;
60;24;412;451;39;;
60;25;451;491;40;40,6;
60;25;491;532;41;;
60;25;532;572;40;;
60;25;572;614;42;;
60;25;614;655;41;;
60;25;655;695;40;;
60;25;695;734;39;;
60;25;734;774;40;;
60;25;774;815;41;;
60;25;815;857;42;;
60;26;857;899;42;42,2;
60;26;899;942;43;;
60;26;942;984;42;;
60;26;984;1025;41;;
60;26;1025;1067;42;;
60;26;1067;1110;43;;
60;26;1110;1152;42;;
60;26;1152;1194;42;;
60;26;1194;1236;42;;
60;26;1236;1279;43;;
60;27;1279;1322;43;44,4;
60;27;1322;1364;42;;
60;27;1364;1413;49;;
60;27;1413;1458;45;;
60;27;1458;1502;44;;
60;27;1502;1545;43;;
60;27;1545;1590;45;;
60;27;1590;1634;44;;
60;27;1634;1679;45;;
60;27;1679;1723;44;;
60;28;1723;1768;45;45,2;
60;28;1768;1814;46;;
60;28;1814;1859;45;;
60;28;1859;1903;44;;
60;28;1903;1948;45;;
60;28;1948;1994;46;;
60;28;286;331;45;;
60;28;331;376;45;;
60;28;376;421;45;;
60;28;421;467;46;;
60;29;467;513;46;46,4;
60;29;513;560;47;;
60;29;560;606;46;;
60;29;606;651;45;;
60;29;651;697;46;;
60;29;697;745;48;;
60;29;745;791;46;;
60;29;791;837;46;;
60;29;837;882;45;;
60;29;882;931;49;;
60;30;931;978;47;47,3;
60;30;978;1026;48;;
60;30;1026;1073;47;;
60;30;1073;1122;49;;
60;30;1122;1168;46;;
60;30;1168;1215;47;;
60;30;1215;1263;48;;
60;30;1263;1309;46;;
60;30;1309;1356;47;;
60;30;1356;1404;48;;
60;31;581;619;38;48,2;
60;31;619;668;49;;
60;31;668;721;53;;
60;31;721;773;52;;
60;31;773;823;50;;
60;31;823;870;47;;
60;31;870;921;51;;
60;31;921;970;49;;
60;31;970;1014;44;;
60;31;1014;1063;49;;
60;32;1063;1113;50;51,4;
60;32;1113;1165;52;;
60;32;1165;1219;54;;
60;32;1219;1274;55;;
60;32;1274;1320;46;;
60;32;1320;1375;55;;
60;32;1375;1426;51;;
60;32;1426;1479;53;;
60;32;1479;1527;48;;
60;32;1527;1577;50;;
60;33;1577;1630;53;53,5;
60;33;1630;1685;55;;
60;33;1685;1742;57;;
60;33;1742;1796;54;;
60;33;1796;1851;55;;
60;33;1851;1905;54;;
60;33;1905;1957;52;;
60;33;350;398;48;;
60;33;398;451;53;;
60;33;451;505;54;;
60;34;505;564;59;54;
60;34;564;614;50;;
60;34;614;671;57;;
60;34;671;728;57;;
60;34;728;781;53;;
60;34;781;835;54;;
60;34;835;888;53;;
60;34;888;939;51;;
60;34;939;992;53;;
60;34;992;1045;53;;
60;35;1045;1097;52;56,1;
60;35;1097;1157;60;;
60;35;1157;1213;56;;
60;35;1213;1269;56;;
60;35;1269;1328;59;;
60;35;1328;1384;56;;
60;35;1384;1441;57;;
60;35;1441;1501;60;;
60;35;1501;1554;53;;
60;35;1554;1606;52;;
60;36;1606;1663;57;56,7;
60;36;1663;1721;58;;
60;36;1721;1783;62;;
60;36;1783;1839;56;;
60;36;1839;1895;56;;
60;36;1895;1952;57;;
60;36;276;330;54;;
60;36;330;384;54;;
60;36;384;440;56;;
60;36;440;497;57;;
60;37;497;550;53;56,9;
60;37;550;608;58;;
60;37;608;665;57;;
60;37;665;727;62;;
60;37;727;781;54;;
60;37;781;835;54;;
60;37;835;889;54;;
60;37;889;944;55;;
60;37;944;1006;62;;
60;37;1006;1066;60;;
60;38;1066;1127;61;59,6;
60;38;1127;1189;62;;
60;38;1189;1250;61;;
60;38;1250;1309;59;;
60;38;1309;1371;62;;
60;38;1371;1428;57;;
60;38;1428;1487;59;;
60;38;1487;1550;63;;
60;38;1550;1603;53;;
60;38;1603;1662;59;;
60;39;1662;1718;56;61,4;
60;39;1718;1779;61;;
60;39;1779;1844;65;;
60;39;1844;1904;60;;
60;39;1904;1966;62;;
60;39;289;353;64;;
60;39;353;416;63;;
60;39;416;475;59;;
60;39;475;540;65;;
60;39;540;599;59;;
60;40;599;665;66;61,2;
60;40;665;725;60;;
60;40;725;783;58;;
60;40;783;847;64;;
60;40;847;908;61;;
60;40;908;968;60;;
60;40;968;1029;61;;
60;40;1029;1089;60;;
60;40;1089;1151;62;;
60;40;1151;1211;60;;
60;41;1211;1274;63;63,1;
60;41;1274;1333;59;;
60;41;1333;1399;66;;
60;41;1399;1464;65;;
60;41;1464;1529;65;;
60;41;1529;1590;61;;
60;41;1590;1654;64;;
60;41;1654;1718;64;;
60;41;1718;1776;58;;
60;41;1776;1842;66;;
60;42;1842;1903;61;64,2;
60;42;1903;1970;67;;
60;42;245;311;66;;
60;42;311;372;61;;
60;42;372;436;64;;
60;42;436;502;66;;
60;42;502;564;62;;
60;42;564;631;67;;
60;42;631;693;62;;
60;42;693;759;66;;
60;43;759;821;62;65,2;
60;43;821;889;68;;
60;43;889;958;69;;
60;43;958;1019;61;;
60;43;1019;1082;63;;
60;43;1082;1149;67;;
60;43;1149;1210;61;;
60;43;1210;1280;70;;
60;43;1280;1341;61;;
60;43;1341;1411;70;;
60;44;1411;1480;69;67,9;
60;44;1480;1549;69;;
60;44;1549;1620;71;;
60;44;1620;1691;71;;
60;44;1691;1761;70;;
60;44;1761;1826;65;;
60;44;1826;1893;67;;
60;44;1893;1960;67;;
60;44;267;329;62;;
60;44;329;397;68;;
60;45;397;466;69;67,2;
60;45;466;531;65;;
60;45;531;599;68;;
60;45;599;663;64;;
60;45;663;729;66;;
60;45;729;798;69;;
60;45;798;866;68;;
60;45;866;935;69;;
60;45;935;1003;68;;
60;45;1003;1069;66;;
60;46;1069;1134;65;68,1;
60;46;1134;1199;65;;
60;46;1199;1269;70;;
60;46;1269;1335;66;;
60;46;1335;1408;73;;
60;46;1408;1476;68;;
60;46;1476;1548;72;;
60;46;1548;1612;64;;
60;46;1612;1684;72;;
60;46;1684;1750;66;;
60;47;1750;1824;74;69,7;
60;47;1824;1894;70;;
60;47;1894;1964;70;;
60;47;289;356;67;;
60;47;356;423;67;;
60;47;423;492;69;;
60;47;492;561;69;;
60;47;561;634;73;;
60;47;634;703;69;;
60;47;703;772;69;;
60;48;772;842;70;71,6;
60;48;842;912;70;;
60;48;912;979;67;;
60;48;979;1050;71;;
60;48;1050;1122;72;;
60;48;1122;1194;72;;
60;48;1194;1266;72;;
60;48;1266;1340;74;;
60;48;1340;1414;74;;
60;48;1414;1488;74;;
60;49;1488;1564;76;72,3;
60;49;1564;1635;71;;
60;49;1635;1707;72;;
60;49;1707;1784;77;;
60;49;1784;1853;69;;
60;49;1853;1921;68;;
60;49;1921;1991;70;;
60;49;291;367;76;;
60;49;367;441;74;;
60;49;441;511;70;;
60;50;511;585;74;71,4;
60;50;585;655;70;;
60;50;655;725;70;;
60;50;725;796;71;;
60;50;796;865;69;;
60;50;865;934;69;;
60;50;934;1003;69;;
60;50;1003;1076;73;;
60;50;1076;1152;76;;
60;50;1152;1225;73;;
60;51;1225;1302;77;72,1;
60;51;1302;1378;76;;
60;51;1378;1446;68;;
60;51;1446;1520;74;;
60;51;1520;1588;68;;
60;51;1588;1658;70;;
60;51;1658;1727;69;;
60;51;1727;1800;73;;
60;51;1800;1876;76;;
60;51;1876;1946;70;;
60;52;278;350;72;73,8;
60;52;350;426;76;;
60;52;426;502;76;;
60;52;502;572;70;;
60;52;572;643;71;;
60;52;643;714;71;;
60;52;714;787;73;;
60;52;787;865;78;;
60;52;865;939;74;;
60;52;939;1016;77;;
60;53;1016;1095;79;74,6;
60;53;1095;1169;74;;
60;53;1169;1241;72;;
60;53;1241;1319;78;;
60;53;1319;1396;77;;
60;53;1396;1466;70;;
60;53;1466;1542;76;;
60;53;1542;1616;74;;
60;53;1616;1689;73;;
60;53;1689;1762;73;;
60;54;1762;1836;74;75,7;
60;54;1836;1916;80;;
60;54;1916;1993;77;;
60;54;298;370;72;;
60;54;370;443;73;;
60;54;443;519;76;;
60;54;519;595;76;;
60;54;595;667;72;;
60;54;667;747;80;;
60;54;747;824;77;;
60;55;824;896;72;73,8;
60;55;896;968;72;;
60;55;968;1040;72;;
60;55;1040;1114;74;;
60;55;1114;1189;75;;
60;55;1189;1262;73;;
60;55;1262;1339;77;;
60;55;1339;1417;78;;
60;55;1417;1490;73;;
60;55;1490;1562;72;;
60;56;1562;1639;77;73,5;
60;56;1639;1710;71;;
60;56;1710;1781;71;;
60;56;1781;1857;76;;
60;56;1857;1928;71;;
60;56;1928;2000;72;;
60;56;289;363;74;;
60;56;363;435;72;;
60;56;435;512;77;;
60;56;512;586;74;;
60;57;586;660;74;73,8;
60;57;660;731;71;;
60;57;731;805;74;;
60;57;805;880;75;;
60;57;880;956;76;;
60;57;956;1033;77;;
60;57;1033;1104;71;;
60;57;1104;1176;72;;
60;57;1176;1251;75;;
60;57;1251;1324;73;;
60;58;1324;1398;74;74,7;
60;58;1398;1473;75;;
60;58;1473;1546;73;;
60;58;1546;1625;79;;
60;58;1625;1700;75;;
60;58;1700;1772;72;;
60;58;1772;1847;75;;
60;58;1847;1926;79;;
60;58;1926;1999;73;;
60;58;301;373;72;;
60;59;373;451;78;75,4;
60;59;451;529;78;;
60;59;529;601;72;;
60;59;601;674;73;;
60;59;674;748;74;;
60;59;748;824;76;;
60;59;824;902;78;;
60;59;902;979;77;;
60;59;979;1056;77;;
60;59;1056;1127;71;;
60;60;1127;1199;72;76;
60;60;1199;1273;74;;
60;60;1273;1351;78;;
60;60;1351;1431;80;;
60;60;1431;1505;74;;
60;60;1505;1583;78;;
60;60;1583;1658;75;;
60;60;1658;1738;80;;
60;60;1738;1814;76;;
60;60;1814;1887;73;;
70;1;1286;1287;1;1,1;
70;1;1287;1290;3;;
70;1;1290;1291;1;;
70;1;1291;1292;1;;
70;1;1292;1293;1;;
70;1;1293;1294;1;;
70;1;1294;1295;1;;
70;1;1295;1295;0;;
70;1;1295;1296;1;;
70;1;1296;1297;1;;
70;2;1297;1299;2;1,8;
70;2;1299;1301;2;;
70;2;1301;1303;2;;
70;2;1303;1304;1;;
70;2;1306;1308;2;;
70;2;1308;1309;1;;
70;2;1309;1311;2;;
70;2;1311;1313;2;;
70;2;1313;1315;2;;
70;2;1315;1317;2;;
70;3;1317;1319;2;2,7;
70;3;1319;1322;3;;
70;3;1322;1325;3;;
70;3;1325;1328;3;;
70;3;1328;1330;2;;
70;3;1330;1333;3;;
70;3;1333;1336;3;;
70;3;1336;1339;3;;
70;3;1339;1341;2;;
70;3;1341;1344;3;;
70;4;1344;1347;3;3,4;
70;4;1347;1351;4;;
70;4;1351;1355;4;;
70;4;1355;1358;3;;
70;4;1358;1362;4;;
70;4;1362;1366;4;;
70;4;1366;1369;3;;
70;4;1369;1371;2;;
70;4;1371;1374;3;;
70;4;1374;1378;4;;
70;5;1378;1382;4;4,6;
70;5;1382;1387;5;;
70;5;1387;1392;5;;
70;5;1392;1396;4;;
70;5;1396;1401;5;;
70;5;1401;1405;4;;
70;5;1405;1410;5;;
70;5;1410;1414;4;;
70;5;1414;1417;3;;
70;5;1417;1424;7;;
70;6;1424;1431;7;6,1;
70;6;1431;1438;7;;
70;6;1438;1447;9;;
70;6;1447;1453;6;;
70;6;1453;1458;5;;
70;6;1458;1464;6;;
70;6;1464;1469;5;;
70;6;1469;1475;6;;
70;6;1475;1480;5;;
70;6;1480;1485;5;;
70;7;1485;1491;6;7;
70;7;1491;1499;8;;
70;7;1499;1507;8;;
70;7;1507;1514;7;;
70;7;1514;1520;6;;
70;7;1520;1527;7;;
70;7;1527;1535;8;;
70;7;1535;1542;7;;
70;7;1542;1548;6;;
70;7;1548;1555;7;;
70;8;1555;1564;9;8,5;
70;8;1564;1574;10;;
70;8;1574;1582;8;;
70;8;1582;1590;8;;
70;8;1590;1598;8;;
70;8;1598;1607;9;;
70;8;1607;1615;8;;
70;8;1615;1623;8;;
70;8;1623;1631;8;;
70;8;1631;1640;9;;
70;9;1640;1651;11;9,7;
70;9;1651;1661;10;;
70;9;1661;1671;10;;
70;9;1671;1680;9;;
70;9;1680;1689;9;;
70;9;1689;1699;10;;
70;9;1699;1708;9;;
70;9;1708;1718;10;;
70;9;1718;1728;10;;
70;9;1728;1737;9;;
70;10;1737;1748;11;10,7;
70;10;1748;1760;12;;
70;10;1760;1771;11;;
70;10;1771;1782;11;;
70;10;1782;1794;12;;
70;10;1794;1804;10;;
70;10;1804;1815;11;;
70;10;1815;1825;10;;
70;10;1825;1834;9;;
70;10;1834;1844;10;;
70;11;1844;1855;11;11,7;
70;11;1855;1865;10;;
70;11;1865;1878;13;;
70;11;1878;1889;11;;
70;11;1889;1901;12;;
70;11;1901;1914;13;;
70;11;1914;1926;12;;
70;11;1926;1939;13;;
70;11;1939;1951;12;;
70;11;1951;1961;10;;
70;12;1961;1974;13;12,4;
70;12;1974;1991;17;;
70;12;277;287;10;;
70;12;300;290;10;;
70;12;290;302;12;;
70;12;302;315;13;;
70;12;315;327;12;;
70;12;327;339;12;;
70;12;339;352;13;;
70;12;352;364;12;;
70;13;364;374;10;14,9;
70;13;374;392;18;;
70;13;392;410;18;;
70;13;410;424;14;;
70;13;424;439;15;;
70;13;439;453;14;;
70;13;453;468;15;;
70;13;468;482;14;;
70;13;482;499;17;;
70;13;499;513;14;;
70;14;513;530;17;16,7;
70;14;530;546;16;;
70;14;546;567;21;;
70;14;567;583;16;;
70;14;583;600;17;;
70;14;600;618;18;;
70;14;618;633;15;;
70;14;633;649;16;;
70;14;649;666;17;;
70;14;666;680;14;;
70;15;680;697;17;17,2;
70;15;697;713;16;;
70;15;713;731;18;;
70;15;731;748;17;;
70;15;748;765;17;;
70;15;765;782;17;;
70;15;782;800;18;;
70;15;800;817;17;;
70;15;817;833;16;;
70;15;833;852;19;;
70;16;852;870;18;18,3;
70;16;870;887;17;;
70;16;887;905;18;;
70;16;905;923;18;;
70;16;923;942;19;;
70;16;942;961;19;;
70;16;961;979;18;;
70;16;979;998;19;;
70;16;998;1017;19;;
70;16;1017;1035;18;;
70;17;1035;1056;21;19,2;
70;17;1056;1075;19;;
70;17;1075;1095;20;;
70;17;1095;1114;19;;
70;17;1114;1132;18;;
70;17;1132;1151;19;;
70;17;1151;1171;20;;
70;17;1171;1190;19;;
70;17;1190;1208;18;;
70;17;1208;1227;19;;
70;18;1227;1248;21;20,2;
70;18;1248;1269;21;;
70;18;1269;1290;21;;
70;18;1290;1310;20;;
70;18;1310;1331;21;;
70;18;1331;1350;19;;
70;18;1350;1368;18;;
70;18;1368;1388;20;;
70;18;1388;1409;21;;
70;18;1409;1429;20;;
70;19;1429;1450;21;21,6;
70;19;1450;1472;22;;
70;19;1472;1495;23;;
70;19;1495;1517;22;;
70;19;1517;1538;21;;
70;19;1538;1560;22;;
70;19;1560;1581;21;;
70;19;1581;1603;22;;
70;19;1603;1624;21;;
70;19;1624;1645;21;;
70;20;1645;1668;23;22,9;
70;20;1668;1691;23;;
70;20;1691;1715;24;;
70;20;1715;1739;24;;
70;20;1739;1763;24;;
70;20;1763;1785;22;;
70;20;1785;1808;23;;
70;20;1808;1830;22;;
70;20;1830;1852;22;;
70;20;1852;1874;22;;
70;21;1874;1898;24;24;
70;21;1898;1922;24;;
70;21;1922;1946;24;;
70;21;1946;1974;28;;
70;21;456;481;25;;
70;21;299;322;23;;
70;21;322;344;22;;
70;21;344;365;21;;
70;21;365;389;24;;
70;21;389;414;25;;
70;22;414;441;27;25,6;
70;22;441;465;24;;
70;22;465;490;25;;
70;22;490;515;25;;
70;22;515;541;26;;
70;22;541;567;26;;
70;22;567;592;25;;
70;22;592;618;26;;
70;22;618;645;27;;
70;22;645;670;25;;
70;23;670;698;28;26,8;
70;23;698;725;27;;
70;23;725;751;26;;
70;23;751;778;27;;
70;23;778;804;26;;
70;23;804;831;27;;
70;23;831;857;26;;
70;23;857;884;27;;
70;23;884;912;28;;
70;23;912;938;26;;
70;24;938;965;27;27,7;
70;24;965;993;28;;
70;24;993;1020;27;;
70;24;1020;1048;28;;
70;24;1048;1076;28;;
70;24;1076;1103;27;;
70;24;1103;1132;29;;
70;24;1132;1160;28;;
70;24;1160;1187;27;;
70;24;1187;1215;28;;
70;25;1215;1244;29;28,8;
70;25;1244;1273;29;;
70;25;1273;1303;30;;
70;25;1303;1331;28;;
70;25;1331;1358;27;;
70;25;1358;1387;29;;
70;25;1387;1417;30;;
70;25;1417;1446;29;;
70;25;1446;1474;28;;
70;25;1474;1503;29;;
70;26;1503;1532;29;29,3;
70;26;1532;1561;29;;
70;26;1561;1591;30;;
70;26;1591;1622;31;;
70;26;1622;1650;28;;
70;26;1650;1680;30;;
70;26;1680;1709;29;;
70;26;1709;1739;30;;
70;26;1739;1768;29;;
70;26;1768;1796;28;;
70;27;1796;1826;30;29,8;
70;27;1826;1857;31;;
70;27;1857;1888;31;;
70;27;1888;1918;30;;
70;27;1918;1950;32;;
70;27;1950;1978;28;;
70;27;689;714;25;;
70;27;310;340;30;;
70;27;340;371;31;;
70;27;371;401;30;;
70;28;401;432;31;31,7;
70;28;432;463;31;;
70;28;463;495;32;;
70;28;495;528;33;;
70;28;528;560;32;;
70;28;560;591;31;;
70;28;591;624;33;;
70;28;624;656;32;;
70;28;656;687;31;;
70;28;687;718;31;;
70;29;718;748;30;32,5;
70;29;748;780;32;;
70;29;780;813;33;;
70;29;813;845;32;;
70;29;845;878;33;;
70;29;878;910;32;;
70;29;910;944;34;;
70;29;944;977;33;;
70;29;977;1011;34;;
70;29;1011;1043;32;;
70;30;1043;1076;33;33,7;
70;30;1076;1110;34;;
70;30;1110;1145;35;;
70;30;1145;1178;33;;
70;30;1178;1213;35;;
70;30;1213;1247;34;;
70;30;1247;1280;33;;
70;30;1280;1314;34;;
70;30;1314;1347;33;;
70;30;1347;1380;33;;
70;31;1380;1415;35;32;
70;31;1415;1442;27;;
70;31;1442;1474;32;;
70;31;1474;1507;33;;
70;31;1507;1539;32;;
70;31;1539;1574;35;;
70;31;1574;1607;33;;
70;31;1607;1640;33;;
70;31;1640;1671;31;;
70;31;1671;1700;29;;
70;32;1700;1736;36;33,9;
70;32;1736;1771;35;;
70;32;1771;1803;32;;
70;32;1803;1840;37;;
70;32;1840;1871;31;;
70;32;1871;1904;33;;
70;32;1904;1937;33;;
70;32;1937;1970;33;;
70;32;256;294;38;;
70;32;294;325;31;;
70;33;325;360;35;32,4;
70;33;360;392;32;;
70;33;392;423;31;;
70;33;423;456;33;;
70;33;456;486;30;;
70;33;486;524;38;;
70;33;524;555;31;;
70;33;555;587;32;;
70;33;587;617;30;;
70;33;617;649;32;;
70;34;649;683;34;33,8;
70;34;683;719;36;;
70;34;719;755;36;;
70;34;755;788;33;;
70;34;788;819;31;;
70;34;819;855;36;;
70;34;855;893;38;;
70;34;893;925;32;;
70;34;925;954;29;;
70;34;954;987;33;;
70;35;987;1025;38;34,8;
70;35;1025;1058;33;;
70;35;1058;1090;32;;
70;35;1090;1129;39;;
70;35;1129;1159;30;;
70;35;1159;1192;33;;
70;35;1192;1225;33;;
70;35;1225;1262;37;;
70;35;1262;1296;34;;
70;35;1296;1335;39;;
70;36;1335;1366;31;35,7;
70;36;1366;1406;40;;
70;36;1406;1437;31;;
70;36;1437;1477;40;;
70;36;1477;1511;34;;
70;36;1511;1548;37;;
70;36;1548;1588;40;;
70;36;1588;1622;34;;
70;36;1622;1656;34;;
70;36;1656;1692;36;;
70;37;1692;1727;35;36;
70;37;1727;1768;41;;
70;37;1768;1801;33;;
70;37;1801;1834;33;;
70;37;1834;1872;38;;
70;37;1872;1913;41;;
70;37;1913;1947;34;;
70;37;1947;1979;32;;
70;37;278;313;35;;
70;37;313;351;38;;
70;38;351;388;37;38;
70;38;388;426;38;;
70;38;426;461;35;;
70;38;461;500;39;;
70;38;500;539;39;;
70;38;539;575;36;;
70;38;575;617;42;;
70;38;617;655;38;;
70;38;655;689;34;;
70;38;689;731;42;;
70;39;731;767;36;39;
70;39;767;808;41;;
70;39;808;848;40;;
70;39;848;884;36;;
70;39;884;919;35;;
70;39;919;960;41;;
70;39;960;1001;41;;
70;39;1001;1042;41;;
70;39;1042;1081;39;;
70;39;1081;1121;40;;
70;40;1121;1158;37;39,9;
70;40;1158;1197;39;;
70;40;1197;1241;44;;
70;40;1241;1285;44;;
70;40;1285;1323;38;;
70;40;1323;1359;36;;
70;40;1359;1398;39;;
70;40;1398;1436;38;;
70;40;1436;1476;40;;
70;40;1476;1520;44;;
70;41;1520;1560;40;41,4;
70;41;1560;1603;43;;
70;41;1603;1647;44;;
70;41;1647;1684;37;;
70;41;1684;1724;40;;
70;41;1724;1767;43;;
70;41;1767;1807;40;;
70;41;1807;1849;42;;
70;41;1849;1892;43;;
70;41;1892;1934;42;;
70;42;1934;1975;41;43,8;
70;42;254;300;46;;
70;42;300;345;45;;
70;42;345;391;46;;
70;42;391;438;47;;
70;42;438;484;46;;
70;42;484;522;38;;
70;42;522;566;44;;
70;42;566;609;43;;
70;42;609;651;42;;
70;43;651;696;45;44,6;
70;43;696;740;44;;
70;43;740;787;47;;
70;43;787;830;43;;
70;43;830;875;45;;
70;43;875;921;46;;
70;43;921;963;42;;
70;43;963;1008;45;;
70;43;1008;1056;48;;
70;43;1056;1097;41;;
70;44;1097;1142;45;45,3;
70;44;1142;1184;42;;
70;44;1184;1228;44;;
70;44;1228;1275;47;;
70;44;1275;1316;41;;
70;44;1316;1362;46;;
70;44;1362;1411;49;;
70;44;1411;1456;45;;
70;44;1456;1500;44;;
70;44;1500;1550;50;;
70;45;1550;1596;46;46;
70;45;1596;1640;44;;
70;45;1640;1682;42;;
70;45;1682;1730;48;;
70;45;1730;1773;43;;
70;45;1773;1822;49;;
70;45;1822;1873;51;;
70;45;1873;1919;46;;
70;45;1919;1964;45;;
70;45;276;322;46;;
70;46;322;370;48;47,4;
70;46;370;418;48;;
70;46;418;470;52;;
70;46;470;516;46;;
70;46;516;561;45;;
70;46;561;605;44;;
70;46;605;651;46;;
70;46;651;700;49;;
70;46;700;744;44;;
70;46;744;796;52;;
70;47;796;842;46;47,5;
70;47;842;888;46;;
70;47;888;934;46;;
70;47;934;979;45;;
70;47;979;1030;51;;
70;47;1030;1076;46;;
70;47;1076;1126;50;;
70;47;1126;1178;52;;
70;47;1178;1227;49;;
70;47;1227;1271;44;;
70;48;1271;1322;51;47,2;
70;48;1322;1370;48;;
70;48;1370;1422;52;;
70;48;1422;1466;44;;
70;48;1466;1512;46;;
70;48;1512;1556;44;;
70;48;1556;1601;45;;
70;48;1601;1646;45;;
70;48;1646;1696;50;;
70;48;1696;1743;47;;
70;49;1743;1793;50;48,8;
70;49;1793;1839;46;;
70;49;1839;1887;48;;
70;49;1887;1936;49;;
70;49;1936;1981;45;;
70;49;279;328;49;;
70;49;328;380;52;;
70;49;380;433;53;;
70;49;433;478;45;;
70;49;478;529;51;;
70;50;529;577;48;49,8;
70;50;577;624;47;;
70;50;624;671;47;;
70;50;671;718;47;;
70;50;718;767;49;;
70;50;767;821;54;;
70;50;821;874;53;;
70;50;874;922;48;;
70;50;922;973;51;;
70;50;973;1027;54;;
70;51;1027;1073;46;49;
70;51;1073;1119;46;;
70;51;1119;1165;46;;
70;51;1165;1218;53;;
70;51;1218;1267;49;;
70;51;1267;1318;51;;
70;51;1318;1365;47;;
70;51;1365;1417;52;;
70;51;1417;1468;51;;
70;51;1468;1517;49;;
70;52;1517;1564;47;51,6;
70;52;1564;1619;55;;
70;52;1619;1672;53;;
70;52;1672;1726;54;;
70;52;1726;1773;47;;
70;52;1773;1827;54;;
70;52;1827;1880;53;;
70;52;1880;1935;55;;
70;52;1935;1984;49;;
70;52;275;324;49;;
70;53;324;381;57;53,3;
70;53;381;436;55;;
70;53;436;491;55;;
70;53;491;540;49;;
70;53;540;588;48;;
70;53;588;642;54;;
70;53;642;698;56;;
70;53;698;754;56;;
70;53;754;802;48;;
70;53;802;857;55;;
70;54;857;909;52;55,4;
70;54;909;968;59;;
70;54;968;1020;52;;
70;54;1020;1077;57;;
70;54;1077;1130;53;;
70;54;1130;1187;57;;
70;54;1187;1246;59;;
70;54;1246;1301;55;;
70;54;1301;1355;54;;
70;54;1355;1411;56;;
70;55;1411;1463;52;55,3;
70;55;1463;1516;53;;
70;55;1516;1571;55;;
70;55;1571;1627;56;;
70;55;1627;1682;55;;
70;55;1682;1737;55;;
70;55;1737;1789;52;;
70;55;1789;1848;59;;
70;55;1848;1903;55;;
70;55;1903;1964;61;;
70;56;256;310;54;56,3;
70;56;310;369;59;;
70;56;369;423;54;;
70;56;423;476;53;;
70;56;476;533;57;;
70;56;533;586;53;;
70;56;586;640;54;;
70;56;640;701;61;;
70;56;701;761;60;;
70;56;761;819;58;;
70;57;819;874;55;57,6;
70;57;874;933;59;;
70;57;933;991;58;;
70;57;991;1053;62;;
70;57;1053;1112;59;;
70;57;1112;1168;56;;
70;57;1168;1223;55;;
70;57;1223;1276;53;;
70;57;1276;1337;61;;
70;57;1337;1395;58;;
70;58;1395;1458;63;59;
70;58;1458;1514;56;;
70;58;1514;1573;59;;
70;58;1573;1632;59;;
70;58;1632;1688;56;;
70;58;1688;1750;62;;
70;58;1750;1813;63;;
70;58;1813;1874;61;;
70;58;1874;1931;57;;
70;58;1931;1985;54;;
70;59;265;327;62;60,6;
70;59;327;387;60;;
70;59;387;445;58;;
70;59;445;508;63;;
70;59;508;567;59;;
70;59;567;624;57;;
70;59;624;686;62;;
70;59;686;746;60;;
70;59;746;811;65;;
70;59;811;871;60;;
70;60;871;930;59;60,5;
70;60;930;995;65;;
70;60;995;1053;58;;
70;60;1053;1116;63;;
70;60;1116;1179;63;;
70;60;1179;1237;58;;
70;60;1237;1295;58;;
70;60;1295;1353;58;;
70;60;1353;1413;60;;
70;60;1413;1476;63;;
80;1;1294;1295;1;1,1;
80;1;1300;1301;1;;
80;1;1301;1302;1;;
80;1;1302;1303;1;;
80;1;1303;1304;1;;
80;1;1304;1306;2;;
80;1;1304;1305;1;;
80;1;1305;1306;1;;
80;1;1306;1307;1;;
80;1;1307;1308;1;;
80;2;1308;1309;1;1,6;
80;2;1309;1311;2;;
80;2;1311;1312;1;;
80;2;1312;1314;2;;
80;2;1314;1316;2;;
80;2;1316;1317;1;;
80;2;1317;1319;2;;
80;2;1319;1320;1;;
80;2;1320;1322;2;;
80;2;1322;1324;2;;
80;3;1324;1326;2;2,3;
80;3;1326;1328;2;;
80;3;1328;1331;3;;
80;3;1331;1333;2;;
80;3;1333;1335;2;;
80;3;1335;1338;3;;
80;3;1338;1340;2;;
80;3;1340;1343;3;;
80;3;1343;1345;2;;
80;3;1345;1347;2;;
80;4;1347;1351;4;3,2;
80;4;1351;1354;3;;
80;4;1354;1357;3;;
80;4;1357;1360;3;;
80;4;1360;1363;3;;
80;4;1363;1366;3;;
80;4;1366;1369;3;;
80;4;1369;1373;4;;
80;4;1373;1376;3;;
80;4;1376;1379;3;;
80;5;1379;1383;4;3,8;
80;5;1383;1387;4;;
80;5;1387;1391;4;;
80;5;1391;1394;3;;
80;5;1394;1398;4;;
80;5;1398;1402;4;;
80;5;1402;1406;4;;
80;5;1406;1410;4;;
80;5;1410;1414;4;;
80;5;1414;1417;3;;
80;6;1417;1422;5;5,5;
80;6;1422;1430;8;;
80;6;1430;1436;6;;
80;6;1436;1441;5;;
80;6;1441;1447;6;;
80;6;1447;1451;4;;
80;6;1451;1456;5;;
80;6;1456;1462;6;;
80;6;1462;1467;5;;
80;6;1467;1472;5;;
80;7;1472;1480;8;6,7;
80;7;1480;1487;7;;
80;7;1487;1495;8;;
80;7;1495;1501;6;;
80;7;1501;1508;7;;
80;7;1508;1514;6;;
80;7;1514;1521;7;;
80;7;1521;1527;6;;
80;7;1527;1533;6;;
80;7;1533;1539;6;;
80;8;1539;1547;8;8,3;
80;8;1547;1556;9;;
80;8;1556;1565;9;;
80;8;1565;1572;7;;
80;8;1572;1580;8;;
80;8;1580;1588;8;;
80;8;1588;1596;8;;
80;8;1596;1604;8;;
80;8;1604;1613;9;;
80;8;1613;1622;9;;
80;9;1622;1630;8;9,2;
80;9;1630;1641;11;;
80;9;1641;1650;9;;
80;9;1650;1659;9;;
80;9;1659;1669;10;;
80;9;1669;1677;8;;
80;9;1677;1686;9;;
80;9;1686;1696;10;;
80;9;1696;1705;9;;
80;9;1705;1714;9;;
80;10;1714;1722;8;9,7;
80;10;1722;1733;11;;
80;10;1733;1740;7;;
80;10;1740;1750;10;;
80;10;1750;1761;11;;
80;10;1761;1771;10;;
80;10;1771;1780;9;;
80;10;1780;1790;10;;
80;10;1790;1800;10;;
80;10;1800;1811;11;;
80;11;1811;1826;15;11,8;
80;11;1826;1841;15;;
80;11;1841;1853;12;;
80;11;1853;1865;12;;
80;11;1865;1876;11;;
80;11;1876;1886;10;;
80;11;1886;1899;13;;
80;11;1899;1909;10;;
80;11;1909;1919;10;;
80;11;1919;1929;10;;
80;12;1929;1940;11;14,4;
80;12;1940;1954;14;;
80;12;1954;1967;13;;
80;12;1967;1980;13;;
80;12;1980;1995;15;;
80;12;456;480;24;;
80;12;293;307;14;;
80;12;307;320;13;;
80;12;320;333;13;;
80;12;333;347;14;;
80;13;347;360;13;14,3;
80;13;360;374;14;;
80;13;374;387;13;;
80;13;387;401;14;;
80;13;401;416;15;;
80;13;416;430;14;;
80;13;430;445;15;;
80;13;445;459;14;;
80;13;459;474;15;;
80;13;474;490;16;;
80;14;490;502;12;15,4;
80;14;502;520;18;;
80;14;520;536;16;;
80;14;536;551;15;;
80;14;551;565;14;;
80;14;565;580;15;;
80;14;580;596;16;;
80;14;596;611;15;;
80;14;611;627;16;;
80;14;627;644;17;;
80;15;644;661;17;16,2;
80;15;661;676;15;;
80;15;676;692;16;;
80;15;692;708;16;;
80;15;708;723;15;;
80;15;723;741;18;;
80;15;741;758;17;;
80;15;758;774;16;;
80;15;774;790;16;;
80;15;790;806;16;;
80;16;806;823;17;17,5;
80;16;823;839;16;;
80;16;839;854;15;;
80;16;854;870;16;;
80;16;870;888;18;;
80;16;888;907;19;;
80;16;907;927;20;;
80;16;927;945;18;;
80;16;945;964;19;;
80;16;964;981;17;;
80;17;981;1000;19;18,2;
80;17;1000;1017;17;;
80;17;1017;1033;16;;
80;17;1033;1052;19;;
80;17;1052;1070;18;;
80;17;1070;1089;19;;
80;17;1089;1107;18;;
80;17;1107;1126;19;;
80;17;1126;1144;18;;
80;17;1144;1163;19;;
80;18;1163;1182;19;19,4;
80;18;1182;1202;20;;
80;18;1202;1222;20;;
80;18;1222;1240;18;;
80;18;1240;1259;19;;
80;18;1259;1279;20;;
80;18;1279;1299;20;;
80;18;1299;1318;19;;
80;18;1318;1338;20;;
80;18;1338;1357;19;;
80;19;1357;1377;20;20,1;
80;19;1377;1398;21;;
80;19;1398;1418;20;;
80;19;1418;1438;20;;
80;19;1438;1459;21;;
80;19;1459;1479;20;;
80;19;1479;1498;19;;
80;19;1498;1517;19;;
80;19;1517;1537;20;;
80;19;1537;1558;21;;
80;20;1558;1579;21;21,3;
80;20;1579;1601;22;;
80;20;1601;1623;22;;
80;20;1623;1643;20;;
80;20;1643;1664;21;;
80;20;1664;1684;20;;
80;20;1684;1707;23;;
80;20;1707;1728;21;;
80;20;1728;1750;22;;
80;20;1750;1771;21;;
80;21;1771;1793;22;23,8;
80;21;1793;1818;25;;
80;21;1818;1844;26;;
80;21;1844;1866;22;;
80;21;1866;1888;22;;
80;21;1888;1910;22;;
80;21;1910;1933;23;;
80;21;1933;1956;23;;
80;21;1956;1978;22;;
80;21;456;487;31;;
80;22;287;310;23;24,4;
80;22;310;334;24;;
80;22;334;359;25;;
80;22;359;383;24;;
80;22;383;408;25;;
80;22;408;434;26;;
80;22;434;458;24;;
80;22;458;482;24;;
80;22;482;506;24;;
80;22;506;531;25;;
80;23;531;558;27;25,8;
80;23;558;584;26;;
80;23;584;611;27;;
80;23;611;636;25;;
80;23;636;660;24;;
80;23;660;687;27;;
80;23;687;712;25;;
80;23;712;739;27;;
80;23;739;764;25;;
80;23;764;789;25;;
80;24;789;816;27;27,8;
80;24;816;844;28;;
80;24;844;874;30;;
80;24;874;903;29;;
80;24;903;930;27;;
80;24;930;958;28;;
80;24;958;985;27;;
80;24;985;1013;28;;
80;24;1013;1040;27;;
80;24;1040;1067;27;;
80;25;1067;1097;30;29,3;
80;25;1097;1125;28;;
80;25;1125;1154;29;;
80;25;1154;1184;30;;
80;25;1184;1213;29;;
80;25;1213;1242;29;;
80;25;1242;1272;30;;
80;25;1272;1302;30;;
80;25;1302;1331;29;;
80;25;1331;1360;29;;
80;26;1360;1390;30;30,2;
80;26;1390;1421;31;;
80;26;1421;1451;30;;
80;26;1451;1481;30;;
80;26;1481;1511;30;;
80;26;1511;1542;31;;
80;26;1542;1572;30;;
80;26;1572;1602;30;;
80;26;1602;1632;30;;
80;26;1632;1662;30;;
80;27;1662;1693;31;31,6;
80;27;1693;1725;32;;
80;27;1725;1757;32;;
80;27;1757;1790;33;;
80;27;1790;1820;30;;
80;27;1820;1851;31;;
80;27;1851;1882;31;;
80;27;1882;1914;32;;
80;27;1914;1946;32;;
80;27;1946;1978;32;;
80;28;560;600;40;34,5;
80;28;322;356;34;;
80;28;356;391;35;;
80;28;391;424;33;;
80;28;424;458;34;;
80;28;458;491;33;;
80;28;491;525;34;;
80;28;525;558;33;;
80;28;558;592;34;;
80;28;592;627;35;;
80;29;627;663;36;35,6;
80;29;663;699;36;;
80;29;699;734;35;;
80;29;734;770;36;;
80;29;770;805;35;;
80;29;805;841;36;;
80;29;841;876;35;;
80;29;876;912;36;;
80;29;912;948;36;;
80;29;948;983;35;;
80;30;983;1019;36;37,3;
80;30;1019;1056;37;;
80;30;1056;1094;38;;
80;30;1094;1131;37;;
80;30;1131;1168;37;;
80;30;1168;1206;38;;
80;30;1206;1243;37;;
80;30;1243;1281;38;;
80;30;1281;1319;38;;
80;30;1319;1356;37;;
80;31;1356;1387;31;30,4;
80;31;1387;1420;33;;
80;31;1420;1455;35;;
80;31;1455;1483;28;;
80;31;1483;1510;27;;
80;31;1510;1538;28;;
80;31;1538;1568;30;;
80;31;1568;1594;26;;
80;31;1594;1625;31;;
80;31;1625;1660;35;;
80;32;1660;1691;31;31,4;
80;32;1691;1726;35;;
80;32;1726;1755;29;;
80;32;256;287;31;;
80;32;287;318;31;;
80;32;318;352;34;;
80;32;352;380;28;;
80;32;380;411;31;;
80;32;411;440;29;;
80;32;440;475;35;;
80;33;475;506;31;32,5;
80;33;506;537;31;;
80;33;537;568;31;;
80;33;568;596;28;;
80;33;596;632;36;;
80;33;632;668;36;;
80;33;668;699;31;;
80;33;699;736;37;;
80;33;736;769;33;;
80;33;769;800;31;;
80;34;800;836;36;34,8;
80;34;836;874;38;;
80;34;874;907;33;;
80;34;907;944;37;;
80;34;944;974;30;;
80;34;974;1008;34;;
80;34;1008;1044;36;;
80;34;1044;1081;37;;
80;34;1081;1110;29;;
80;34;1110;1148;38;;
80;35;1148;1188;40;34,9;
80;35;1188;1222;34;;
80;35;1222;1253;31;;
80;35;1253;1289;36;;
80;35;1289;1320;31;;
80;35;1320;1358;38;;
80;35;1358;1396;38;;
80;35;1396;1435;39;;
80;35;1435;1466;31;;
80;35;1466;1497;31;;
80;36;1497;1529;32;36,4;
80;36;1529;1570;41;;
80;36;1570;1603;33;;
80;36;1603;1634;31;;
80;36;1634;1669;35;;
80;36;1669;1703;34;;
80;36;1703;1739;36;;
80;36;1739;1779;40;;
80;36;1779;1820;41;;
80;36;1820;1861;41;;
80;37;1861;1900;39;38,7;
80;37;1900;1936;36;;
80;37;1936;1973;37;;
80;37;289;326;37;;
80;37;326;368;42;;
80;37;368;410;42;;
80;37;410;445;35;;
80;37;445;481;36;;
80;37;481;523;42;;
80;37;523;564;41;;
80;38;564;599;35;39,9;
80;38;599;639;40;;
80;38;639;677;38;;
80;38;677;714;37;;
80;38;714;755;41;;
80;38;755;798;43;;
80;38;798;841;43;;
80;38;841;885;44;;
80;38;885;920;35;;
80;38;920;963;43;;
80;39;963;1001;38;41,6;
80;39;1001;1038;37;;
80;39;1038;1080;42;;
80;39;1080;1125;45;;
80;39;1125;1171;46;;
80;39;1171;1215;44;;
80;39;1215;1253;38;;
80;39;1253;1295;42;;
80;39;1295;1334;39;;
80;39;1334;1379;45;;
80;40;1379;1417;38;40,8;
80;40;1417;1457;40;;
80;40;1457;1496;39;;
80;40;1496;1543;47;;
80;40;1543;1583;40;;
80;40;1583;1630;47;;
80;40;1630;1669;39;;
80;40;1669;1709;40;;
80;40;1709;1747;38;;
80;40;1747;1787;40;;
80;41;1787;1826;39;41,1;
80;41;1826;1866;40;;
80;41;1866;1903;37;;
80;41;1903;1945;42;;
80;41;1945;1986;41;;
80;41;278;323;45;;
80;41;323;368;45;;
80;41;368;409;41;;
80;41;409;449;40;;
80;41;449;490;41;;
80;42;490;528;38;43,1;
80;42;528;574;46;;
80;42;574;612;38;;
80;42;612;656;44;;
80;42;656;703;47;;
80;42;703;747;44;;
80;42;747;792;45;;
80;42;792;833;41;;
80;42;833;877;44;;
80;42;877;921;44;;
80;43;921;970;49;44,3;
80;43;970;1015;45;;
80;43;1015;1061;46;;
80;43;1061;1101;40;;
80;43;1101;1145;44;;
80;43;1145;1189;44;;
80;43;1189;1230;41;;
80;43;1230;1276;46;;
80;43;1276;1322;46;;
80;43;1322;1364;42;;
80;44;1364;1405;41;44,2;
80;44;1405;1447;42;;
80;44;1447;1490;43;;
80;44;1490;1536;46;;
80;44;1536;1585;49;;
80;44;1585;1634;49;;
80;44;1634;1675;41;;
80;44;1675;1717;42;;
80;44;1717;1764;47;;
80;44;1764;1806;42;;
80;45;1806;1847;41;45;
80;45;1847;1893;46;;
80;45;1893;1934;41;;
80;45;1934;1977;43;;
80;45;298;344;46;;
80;45;344;388;44;;
80;45;388;431;43;;
80;45;431;480;49;;
80;45;480;530;50;;
80;45;530;577;47;;
80;46;577;624;47;47,5;
80;46;624;669;45;;
80;46;669;715;46;;
80;46;715;762;47;;
80;46;762;805;43;;
80;46;805;853;48;;
80;46;853;903;50;;
80;46;903;951;48;;
80;46;951;1001;50;;
80;46;1001;1052;51;;
80;47;1052;1101;49;48,3;
80;47;1101;1151;50;;
80;47;1151;1203;52;;
80;47;1203;1248;45;;
80;47;1248;1297;49;;
80;47;1297;1341;44;;
80;47;1341;1386;45;;
80;47;1386;1439;53;;
80;47;1439;1491;52;;
80;47;1491;1535;44;;
80;48;1535;1586;51;48,7;
80;48;1586;1637;51;;
80;48;1637;1687;50;;
80;48;1687;1733;46;;
80;48;1733;1779;46;;
80;48;1779;1824;45;;
80;48;1824;1877;53;;
80;48;1877;1923;46;;
80;48;1923;1971;48;;
80;48;301;352;51;;
80;49;352;398;46;49,2;
80;49;398;444;46;;
80;49;444;498;54;;
80;49;498;545;47;;
80;49;545;598;53;;
80;49;598;650;52;;
80;49;650;698;48;;
80;49;698;747;49;;
80;49;747;797;50;;
80;49;797;844;47;;
80;50;844;895;51;50,6;
80;50;895;949;54;;
80;50;949;997;48;;
80;50;997;1043;46;;
80;50;1043;1093;50;;
80;50;1093;1144;51;;
80;50;1144;1194;50;;
80;50;1194;1241;47;;
80;50;1241;1295;54;;
80;50;1295;1350;55;;
80;51;1350;1405;55;51,5;
80;51;1405;1457;52;;
80;51;1457;1509;52;;
80;51;1509;1563;54;;
80;51;1563;1615;52;;
80;51;1615;1668;53;;
80;51;1668;1721;53;;
80;51;1721;1770;49;;
80;51;1770;1818;48;;
80;51;1818;1865;47;;
80;52;1865;1918;53;52,2;
80;52;1918;1974;56;;
80;52;267;322;55;;
80;52;322;370;48;;
80;52;370;424;54;;
80;52;424;472;48;;
80;52;472;525;53;;
80;52;525;580;55;;
80;52;580;629;49;;
80;52;629;680;51;;
80;53;680;734;54;53,7;
80;53;734;787;53;;
80;53;787;839;52;;
80;53;839;889;50;;
80;53;889;946;57;;
80;53;946;995;49;;
80;53;995;1051;56;;
80;53;1051;1109;58;;
80;53;1109;1166;57;;
80;53;1166;1217;51;;
80;54;1217;1276;59;55,7;
80;54;1276;1332;56;;
80;54;1332;1384;52;;
80;54;1384;1439;55;;
80;54;1439;1494;55;;
80;54;1494;1551;57;;
80;54;1551;1608;57;;
80;54;1608;1666;58;;
80;54;1666;1721;55;;
80;54;1721;1774;53;;
80;55;1774;1826;52;54,8;
80;55;1826;1882;56;;
80;55;1882;1936;54;;
80;55;1936;1988;52;;
80;55;256;310;54;;
80;55;310;369;59;;
80;55;369;424;55;;
80;55;424;479;55;;
80;55;479;531;52;;
80;55;531;590;59;;
80;56;590;646;56;55,4;
80;56;646;701;55;;
80;56;701;761;60;;
80;56;761;812;51;;
80;56;812;867;55;;
80;56;867;926;59;;
80;56;926;979;53;;
80;56;979;1033;54;;
80;56;1033;1091;58;;
80;56;1091;1144;53;;
80;57;1144;1203;59;57,7;
80;57;1203;1256;53;;
80;57;1256;1309;53;;
80;57;1309;1369;60;;
80;57;1369;1428;59;;
80;57;1428;1486;58;;
80;57;1486;1547;61;;
80;57;1547;1607;60;;
80;57;1607;1664;57;;
80;57;1664;1721;57;;
80;58;1721;1778;57;58,3;
80;58;1778;1839;61;;
80;58;1839;1899;60;;
80;58;1899;1959;60;;
80;58;289;348;59;;
80;58;348;402;54;;
80;58;402;462;60;;
80;58;462;524;62;;
80;58;524;579;55;;
80;58;579;634;55;;
80;59;634;697;63;60,1;
80;59;697;755;58;;
80;59;755;814;59;;
80;59;814;870;56;;
80;59;870;928;58;;
80;59;928;992;64;;
80;59;992;1053;61;;
80;59;1053;1114;61;;
80;59;1114;1171;57;;
80;59;1171;1235;64;;
80;60;1235;1297;62;61,3;
80;60;1297;1354;57;;
80;60;1354;1420;66;;
80;60;1420;1480;60;;
80;60;1480;1540;60;;
80;60;1540;1597;57;;
80;60;1597;1663;66;;
80;60;1663;1723;60;;
80;60;1723;1787;64;;
80;60;1787;1848;61;;
90;1;251;252;1;1;
90;1;252;253;1;;
90;1;253;253;0;;
90;1;253;254;1;;
90;1;254;255;1;;
90;1;255;257;2;;
90;1;257;258;1;;
90;1;258;259;1;;
90;1;259;259;0;;
90;1;259;261;2;;
90;2;261;265;4;2,4;
90;2;265;266;1;;
90;2;266;269;3;;
90;2;269;271;2;;
90;2;271;274;3;;
90;2;274;276;2;;
90;2;276;278;2;;
90;2;278;281;3;;
90;2;281;283;2;;
90;2;283;285;2;;
90;3;285;288;3;3,2;
90;3;288;291;3;;
90;3;291;294;3;;
90;3;294;297;3;;
90;3;297;300;3;;
90;3;300;304;4;;
90;3;304;307;3;;
90;3;307;310;3;;
90;3;310;313;3;;
90;3;313;317;4;;
90;4;317;322;5;4,2;
90;4;322;326;4;;
90;4;326;330;4;;
90;4;330;334;4;;
90;4;334;338;4;;
90;4;338;343;5;;
90;4;343;347;4;;
90;4;347;351;4;;
90;4;351;354;3;;
90;4;354;359;5;;
90;5;359;364;5;5,2;
90;5;364;369;5;;
90;5;369;374;5;;
90;5;374;379;5;;
90;5;379;384;5;;
90;5;384;390;6;;
90;5;390;396;6;;
90;5;396;401;5;;
90;5;401;406;5;;
90;5;406;411;5;;
90;6;411;418;7;6,2;
90;6;418;423;5;;
90;6;423;430;7;;
90;6;430;434;4;;
90;6;434;441;7;;
90;6;441;447;6;;
90;6;447;454;7;;
90;6;454;460;6;;
90;6;460;467;7;;
90;6;467;473;6;;
90;7;473;480;7;7,1;
90;7;480;487;7;;
90;7;487;495;8;;
90;7;495;502;7;;
90;7;502;509;7;;
90;7;509;516;7;;
90;7;516;524;8;;
90;7;524;530;6;;
90;7;530;537;7;;
90;7;537;544;7;;
90;8;544;552;8;8,1;
90;8;552;561;9;;
90;8;561;568;7;;
90;8;568;577;9;;
90;8;577;585;8;;
90;8;585;593;8;;
90;8;593;602;9;;
90;8;602;609;7;;
90;8;609;617;8;;
90;8;617;625;8;;
90;9;625;636;11;9,2;
90;9;636;644;8;;
90;9;644;653;9;;
90;9;653;658;5;;
90;9;658;669;11;;
90;9;669;678;9;;
90;9;678;688;10;;
90;9;688;699;11;;
90;9;699;709;10;;
90;9;709;717;8;;
90;10;717;727;10;10,6;
90;10;727;740;13;;
90;10;740;750;10;;
90;10;750;759;9;;
90;10;759;769;10;;
90;10;769;779;10;;
90;10;779;790;11;;
90;10;790;799;9;;
90;10;799;812;13;;
90;10;812;823;11;;
90;11;823;834;11;11,3;
90;11;834;845;11;;
90;11;845;856;11;;
90;11;856;867;11;;
90;11;867;878;11;;
90;11;878;889;11;;
90;11;889;901;12;;
90;11;901;911;10;;
90;11;911;924;13;;
90;11;924;936;12;;
90;12;936;947;11;12,9;
90;12;947;960;13;;
90;12;960;982;22;;
90;12;982;993;11;;
90;12;993;1005;12;;
90;12;1005;1018;13;;
90;12;1018;1029;11;;
90;12;1029;1041;12;;
90;12;1041;1052;11;;
90;12;1052;1065;13;;
90;13;1065;1078;13;13,4;
90;13;1078;1089;11;;
90;13;1089;1104;15;;
90;13;1104;1119;15;;
90;13;1119;1134;15;;
90;13;1134;1146;12;;
90;13;1146;1159;13;;
90;13;1159;1171;12;;
90;13;1171;1186;15;;
90;13;1186;1199;13;;
90;14;1199;1212;13;14;
90;14;1212;1226;14;;
90;14;1226;1239;13;;
90;14;1239;1255;16;;
90;14;1255;1265;10;;
90;14;1265;1279;14;;
90;14;1279;1294;15;;
90;14;1294;1308;14;;
90;14;1308;1323;15;;
90;14;1323;1339;16;;
90;15;1339;1355;16;15,8;
90;15;1355;1370;15;;
90;15;1370;1383;13;;
90;15;1383;1392;9;;
90;15;1392;1411;19;;
90;15;1411;1430;19;;
90;15;1430;1448;18;;
90;15;1448;1465;17;;
90;15;1465;1481;16;;
90;15;1481;1497;16;;
90;16;1497;1514;17;16,8;
90;16;1514;1533;19;;
90;16;1533;1549;16;;
90;16;1549;1567;18;;
90;16;1567;1583;16;;
90;16;1583;1599;16;;
90;16;1599;1616;17;;
90;16;1616;1632;16;;
90;16;1632;1648;16;;
90;16;1648;1665;17;;
90;17;1665;1682;17;17,2;
90;17;1682;1699;17;;
90;17;1699;1716;17;;
90;17;1716;1734;18;;
90;17;1734;1751;17;;
90;17;1751;1769;18;;
90;17;1769;1786;17;;
90;17;1786;1802;16;;
90;17;1802;1819;17;;
90;17;1819;1837;18;;
90;18;1837;1855;18;18,5;
90;18;1855;1874;19;;
90;18;1874;1892;18;;
90;18;1892;1910;18;;
90;18;1910;1929;19;;
90;18;1929;1947;18;;
90;18;1947;1966;19;;
90;18;1966;1984;18;;
90;18;289;308;19;;
90;18;308;327;19;;
90;19;327;346;19;19,4;
90;19;346;366;20;;
90;19;366;385;19;;
90;19;385;405;20;;
90;19;405;424;19;;
90;19;424;443;19;;
90;19;443;462;19;;
90;19;462;481;19;;
90;19;481;501;20;;
90;19;501;521;20;;
90;20;521;541;20;20,4;
90;20;541;561;20;;
90;20;561;581;20;;
90;20;581;603;22;;
90;20;603;624;21;;
90;20;624;644;20;;
90;20;644;664;20;;
90;20;664;684;20;;
90;20;684;705;21;;
90;20;705;725;20;;
90;21;725;746;21;21,8;
90;21;746;769;23;;
90;21;769;794;25;;
90;21;794;816;22;;
90;21;816;839;23;;
90;21;839;861;22;;
90;21;861;881;20;;
90;21;881;902;21;;
90;21;902;922;20;;
90;21;922;943;21;;
90;22;943;965;22;22,8;
90;22;965;989;24;;
90;22;989;1014;25;;
90;22;1014;1037;23;;
90;22;1037;1059;22;;
90;22;1059;1082;23;;
90;22;1082;1104;22;;
90;22;1104;1126;22;;
90;22;1126;1148;22;;
90;22;1148;1171;23;;
90;23;1171;1194;23;23,5;
90;23;1194;1217;23;;
90;23;1217;1240;23;;
90;23;1240;1264;24;;
90;23;1264;1287;23;;
90;23;1287;1310;23;;
90;23;1310;1334;24;;
90;23;1334;1359;25;;
90;23;1359;1382;23;;
90;23;1382;1406;24;;
90;24;1406;1430;24;24,4;
90;24;1430;1455;25;;
90;24;1455;1481;26;;
90;24;1481;1505;24;;
90;24;1505;1530;25;;
90;24;1530;1554;24;;
90;24;1554;1578;24;;
90;24;1578;1601;23;;
90;24;1601;1625;24;;
90;24;1625;1650;25;;
90;25;1650;1675;25;25,9;
90;25;1675;1702;27;;
90;25;1702;1726;24;;
90;25;1726;1751;25;;
90;25;1751;1777;26;;
90;25;1777;1803;26;;
90;25;1803;1829;26;;
90;25;1829;1856;27;;
90;25;1856;1883;27;;
90;25;1883;1909;26;;
90;26;1909;1935;26;26,4;
90;26;1935;1962;27;;
90;26;1962;1988;26;;
90;26;276;303;27;;
90;26;303;329;26;;
90;26;329;355;26;;
90;26;355;381;26;;
90;26;381;408;27;;
90;26;408;434;26;;
90;26;434;461;27;;
90;27;461;487;26;27,1;
90;27;487;514;27;;
90;27;514;541;27;;
90;27;541;569;28;;
90;27;569;596;27;;
90;27;596;622;26;;
90;27;622;650;28;;
90;27;650;677;27;;
90;27;677;705;28;;
90;27;705;732;27;;
90;28;732;760;28;28,5;
90;28;760;789;29;;
90;28;789;818;29;;
90;28;818;846;28;;
90;28;846;874;28;;
90;28;874;903;29;;
90;28;903;931;28;;
90;28;931;960;29;;
90;28;960;988;28;;
90;28;988;1017;29;;
90;29;1017;1046;29;29,3;
90;29;1046;1076;30;;
90;29;1076;1105;29;;
90;29;1105;1134;29;;
90;29;1134;1164;30;;
90;29;1164;1194;30;;
90;29;1194;1223;29;;
90;29;1223;1252;29;;
90;29;1252;1281;29;;
90;29;1281;1310;29;;
90;30;1310;1340;30;30,1;
90;30;1340;1371;31;;
90;30;1371;1401;30;;
90;30;1401;1430;29;;
90;30;1430;1460;30;;
90;30;1460;1490;30;;
90;30;1490;1520;30;;
90;30;1520;1551;31;;
90;30;1551;1581;30;;
90;30;1581;1611;30;;
90;31;1611;1643;32;31;
90;31;1643;1676;33;;
90;31;1676;1709;33;;
90;31;1709;1743;34;;
90;31;1743;1771;28;;
90;31;1771;1802;31;;
90;31;1802;1829;27;;
90;31;1829;1865;36;;
90;31;1865;1894;29;;
90;31;1894;1921;27;;
90;32;1921;1957;36;32,5;
90;32;1957;1989;32;;
90;32;289;322;33;;
90;32;322;349;27;;
90;32;349;381;32;;
90;32;381;413;32;;
90;32;413;450;37;;
90;32;450;481;31;;
90;32;481;509;28;;
90;32;509;546;37;;
90;33;546;582;36;33,4;
90;33;582;619;37;;
90;33;619;653;34;;
90;33;653;690;37;;
90;33;690;726;36;;
90;33;726;756;30;;
90;33;756;786;30;;
90;33;786;818;32;;
90;33;818;848;30;;
90;33;848;880;32;;
90;34;880;919;39;35,1;
90;34;919;949;30;;
90;34;949;988;39;;
90;34;988;1021;33;;
90;34;1021;1052;31;;
90;34;1052;1082;30;;
90;34;1082;1120;38;;
90;34;1120;1158;38;;
90;34;1158;1195;37;;
90;34;1195;1231;36;;
90;35;1231;1269;38;37,2;
90;35;1269;1305;36;;
90;35;1305;1344;39;;
90;35;1344;1379;35;;
90;35;1379;1419;40;;
90;35;1419;1460;41;;
90;35;1460;1492;32;;
90;35;1492;1530;38;;
90;35;1530;1571;41;;
90;35;1571;1603;32;;
90;36;1603;1638;35;37,3;
90;36;1638;1675;37;;
90;36;1675;1714;39;;
90;36;1714;1749;35;;
90;36;1749;1791;42;;
90;36;1791;1826;35;;
90;36;1826;1866;40;;
90;36;1866;1905;39;;
90;36;1905;1942;37;;
90;36;1942;1976;34;;
90;37;271;305;34;37,6;
90;37;305;345;40;;
90;37;345;383;38;;
90;37;383;420;37;;
90;37;420;461;41;;
90;37;461;498;37;;
90;37;498;536;38;;
90;37;536;571;35;;
90;37;571;612;41;;
90;37;612;647;35;;
90;38;647;689;42;38,9;
90;38;689;728;39;;
90;38;728;767;39;;
90;38;767;801;34;;
90;38;801;840;39;;
90;38;840;879;39;;
90;38;879;920;41;;
90;38;920;962;42;;
90;38;962;996;34;;
90;38;996;1036;40;;
90;39;1036;1077;41;38,3;
90;39;1077;1115;38;;
90;39;1115;1155;40;;
90;39;1155;1194;39;;
90;39;1194;1234;40;;
90;39;1234;1271;37;;
90;39;1271;1310;39;;
90;39;1310;1345;35;;
90;39;1345;1380;35;;
90;39;1380;1419;39;;
90;40;1419;1461;42;41,6;
90;40;1461;1505;44;;
90;40;1505;1549;44;;
90;40;1549;1589;40;;
90;40;1589;1632;43;;
90;40;1632;1673;41;;
90;40;1673;1709;36;;
90;40;1709;1749;40;;
90;40;1749;1792;43;;
90;40;1792;1835;43;;
90;41;1835;1882;47;42,7;
90;41;1882;1921;39;;
90;41;1921;1964;43;;
90;41;278;322;44;;
90;41;322;361;39;;
90;41;361;406;45;;
90;41;406;448;42;;
90;41;448;492;44;;
90;41;492;532;40;;
90;41;532;576;44;;
90;42;576;619;43;44,1;
90;42;619;665;46;;
90;42;665;708;43;;
90;42;708;751;43;;
90;42;751;794;43;;
90;42;794;834;40;;
90;42;834;880;46;;
90;42;880;928;48;;
90;42;928;975;47;;
90;42;975;1017;42;;
90;43;1017;1060;43;46,2;
90;43;1060;1106;46;;
90;43;1106;1148;42;;
90;43;1148;1193;45;;
90;43;1193;1243;50;;
90;43;1243;1291;48;;
90;43;1291;1332;41;;
90;43;1332;1381;49;;
90;43;1381;1431;50;;
90;43;1431;1479;48;;
90;44;1479;1526;47;46,1;
90;44;1526;1575;49;;
90;44;1575;1623;48;;
90;44;1623;1670;47;;
90;44;1670;1713;43;;
90;44;1713;1757;44;;
90;44;1757;1807;50;;
90;44;1807;1851;44;;
90;44;1851;1897;46;;
90;44;1897;1940;43;;
90;45;1940;1991;51;46,9;
90;45;298;343;45;;
90;45;343;392;49;;
90;45;392;440;48;;
90;45;440;483;43;;
90;45;483;529;46;;
90;45;529;574;45;;
90;45;574;618;44;;
90;45;618;667;49;;
90;45;667;716;49;;
90;46;716;759;43;47,1;
90;46;759;808;49;;
90;46;808;851;43;;
90;46;851;894;43;;
90;46;894;940;46;;
90;46;940;991;51;;
90;46;991;1036;45;;
90;46;1036;1085;49;;
90;46;1085;1135;50;;
90;46;1135;1187;52;;
90;47;1187;1239;52;49,2;
90;47;1239;1290;51;;
90;47;1290;1336;46;;
90;47;1336;1382;46;;
90;47;1382;1434;52;;
90;47;1434;1482;48;;
90;47;1482;1528;46;;
90;47;1528;1579;51;;
90;47;1579;1626;47;;
90;47;1626;1679;53;;
90;48;1679;1730;51;49;
90;48;1730;1778;48;;
90;48;1778;1825;47;;
90;48;1825;1873;48;;
90;48;1873;1923;50;;
90;48;1923;1973;50;;
90;48;298;345;47;;
90;48;345;399;54;;
90;48;399;447;48;;
90;48;447;494;47;;
90;49;494;547;53;51;
90;49;547;595;48;;
90;49;595;649;54;;
90;49;649;704;55;;
90;49;704;753;49;;
90;49;753;800;47;;
90;49;800;854;54;;
90;49;854;906;52;;
90;49;906;952;46;;
90;49;952;1004;52;;
90;50;1004;1058;54;52,3;
90;50;1058;1106;48;;
90;50;1106;1160;54;;
90;50;1160;1213;53;;
90;50;1213;1260;47;;
90;50;1260;1310;50;;
90;50;1310;1366;56;;
90;50;1366;1423;57;;
90;50;1423;1474;51;;
90;50;1474;1527;53;;
90;51;1527;1580;53;54;
90;51;1580;1633;53;;
90;51;1633;1690;57;;
90;51;1690;1748;58;;
90;51;1748;1801;53;;
90;51;1801;1859;58;;
90;51;1859;1910;51;;
90;51;1910;1963;53;;
90;51;256;311;55;;
90;51;311;360;49;;
90;52;360;411;51;54,9;
90;52;411;464;53;;
90;52;464;514;50;;
90;52;514;567;53;;
90;52;567;621;54;;
90;52;621;680;59;;
90;52;680;736;56;;
90;52;736;792;56;;
90;52;792;851;59;;
90;52;851;909;58;;
90;53;909;964;55;56;
90;53;964;1019;55;;
90;53;1019;1071;52;;
90;53;1071;1131;60;;
90;53;1131;1188;57;;
90;53;1188;1243;55;;
90;53;1243;1299;56;;
90;53;1299;1354;55;;
90;53;1354;1413;59;;
90;53;1413;1469;56;;
90;54;1469;1527;58;57,9;
90;54;1527;1580;53;;
90;54;1580;1639;59;;
90;54;1639;1699;60;;
90;54;1699;1761;62;;
90;54;1761;1823;62;;
90;54;1823;1877;54;;
90;54;1877;1934;57;;
90;54;1934;1986;52;;
90;54;298;360;62;;
90;55;360;414;54;57,6;
90;55;414;469;55;;
90;55;469;528;59;;
90;55;528;591;63;;
90;55;591;645;54;;
90;55;645;701;56;;
90;55;701;759;58;;
90;55;759;822;63;;
90;55;822;879;57;;
90;55;879;936;57;;
90;56;936;994;58;58,2;
90;56;994;1053;59;;
90;56;1053;1109;56;;
90;56;1109;1166;57;;
90;56;1166;1227;61;;
90;56;1227;1290;63;;
90;56;1290;1345;55;;
90;56;1345;1406;61;;
90;56;1406;1461;55;;
90;56;1461;1518;57;;
90;57;1518;1582;64;60,4;
90;57;1582;1643;61;;
90;57;1643;1701;58;;
90;57;1701;1761;60;;
90;57;1761;1825;64;;
90;57;1825;1883;58;;
90;57;1883;1946;63;;
90;57;276;334;58;;
90;57;334;394;60;;
90;57;394;452;58;;
90;58;452;517;65;64,1;
90;58;517;582;65;;
90;58;582;644;62;;
90;58;644;706;62;;
90;58;706;772;66;;
90;58;772;838;66;;
90;58;838;904;66;;
90;58;904;967;63;;
90;58;967;1033;66;;
90;58;1033;1093;60;;
90;59;1093;1154;61;64,4;
90;59;1154;1219;65;;
90;59;1219;1286;67;;
90;59;1286;1347;61;;
90;59;1347;1414;67;;
90;59;1414;1480;66;;
90;59;1480;1544;64;;
90;59;1544;1610;66;;
90;59;1610;1672;62;;
90;59;1672;1737;65;;
90;60;1737;1804;67;65,9;
90;60;1804;1869;65;;
90;60;1869;1938;69;;
90;60;275;343;68;;
90;60;343;412;69;;
90;60;412;473;61;;
90;60;473;537;64;;
90;60;537;603;66;;
90;60;603;671;68;;
90;60;671;733;62;;
100;1;259;256;3;0,8;
100;1;256;258;2;;
100;1;258;256;2;;
100;1;256;256;0;;
100;1;256;256;0;;
100;1;256;256;0;;
100;1;256;257;1;;
100;1;257;257;0;;
100;1;257;257;0;;
100;1;257;257;0;;
100;2;257;261;4;1,1;
100;2;261;262;1;;
100;2;262;263;1;;
100;2;263;263;0;;
100;2;263;265;2;;
100;2;265;266;1;;
100;2;266;267;1;;
100;2;267;267;0;;
100;2;267;267;0;;
100;2;267;268;1;;
100;3;268;271;3;1,9;
100;3;271;274;3;;
100;3;274;278;4;;
100;3;278;280;2;;
100;3;280;281;1;;
100;3;281;282;1;;
100;3;282;283;1;;
100;3;283;285;2;;
100;3;285;286;1;;
100;3;286;287;1;;
100;4;287;291;4;2,7;
100;4;291;293;2;;
100;4;293;297;4;;
100;4;297;300;3;;
100;4;300;302;2;;
100;4;302;305;3;;
100;4;305;308;3;;
100;4;308;310;2;;
100;4;310;312;2;;
100;4;312;314;2;;
100;5;314;319;5;3,7;
100;5;319;323;4;;
100;5;323;328;5;;
100;5;328;332;4;;
100;5;332;335;3;;
100;5;335;338;3;;
100;5;338;342;4;;
100;5;342;345;3;;
100;5;345;349;4;;
100;5;349;351;2;;
100;6;351;356;5;4,8;
100;6;356;362;6;;
100;6;362;368;6;;
100;6;368;372;4;;
100;6;372;377;5;;
100;6;377;381;4;;
100;6;381;385;4;;
100;6;385;390;5;;
100;6;390;394;4;;
100;6;394;399;5;;
100;7;399;405;6;6;
100;7;405;412;7;;
100;7;412;418;6;;
100;7;418;424;6;;
100;7;424;429;5;;
100;7;429;435;6;;
100;7;435;442;7;;
100;7;442;448;6;;
100;7;448;453;5;;
100;7;453;459;6;;
100;8;459;466;7;6,6;
100;8;466;475;9;;
100;8;475;482;7;;
100;8;482;488;6;;
100;8;488;493;5;;
100;8;493;499;6;;
100;8;499;506;7;;
100;8;506;512;6;;
100;8;512;519;7;;
100;8;519;525;6;;
100;9;525;533;8;7,3;
100;9;533;542;9;;
100;9;542;550;8;;
100;9;550;556;6;;
100;9;556;563;7;;
100;9;563;570;7;;
100;9;570;576;6;;
100;9;576;583;7;;
100;9;583;591;8;;
100;9;591;598;7;;
100;10;598;605;7;8,5;
100;10;605;616;11;;
100;10;616;626;10;;
100;10;626;634;8;;
100;10;634;641;7;;
100;10;641;649;8;;
100;10;649;658;9;;
100;10;658;666;8;;
100;10;666;675;9;;
100;10;675;683;8;;
100;11;683;692;9;9;
100;11;692;701;9;;
100;11;701;710;9;;
100;11;710;719;9;;
100;11;719;728;9;;
100;11;728;737;9;;
100;11;737;745;8;;
100;11;745;755;10;;
100;11;755;764;9;;
100;11;764;773;9;;
100;12;773;784;11;9,9;
100;12;784;796;12;;
100;12;796;808;12;;
100;12;808;818;10;;
100;12;818;828;10;;
100;12;828;837;9;;
100;12;837;846;9;;
100;12;846;854;8;;
100;12;854;863;9;;
100;12;863;872;9;;
100;13;872;883;11;10,9;
100;13;883;895;12;;
100;13;895;906;11;;
100;13;906;916;10;;
100;13;916;927;11;;
100;13;927;939;12;;
100;13;939;949;10;;
100;13;949;960;11;;
100;13;960;971;11;;
100;13;971;981;10;;
100;14;981;993;12;11,8;
100;14;993;1004;11;;
100;14;1004;1019;15;;
100;14;1019;1031;12;;
100;14;1031;1042;11;;
100;14;1042;1054;12;;
100;14;1054;1064;10;;
100;14;1064;1075;11;;
100;14;1075;1087;12;;
100;14;1087;1099;12;;
100;15;1099;1111;12;12,8;
100;15;1111;1123;12;;
100;15;1123;1137;14;;
100;15;1137;1150;13;;
100;15;1150;1162;12;;
100;15;1162;1175;13;;
100;15;1175;1188;13;;
100;15;1188;1202;14;;
100;15;1202;1214;12;;
100;15;1214;1227;13;;
100;16;1227;1240;13;13,2;
100;16;1240;1253;13;;
100;16;1253;1267;14;;
100;16;1267;1281;14;;
100;16;1281;1294;13;;
100;16;1294;1306;12;;
100;16;1306;1319;13;;
100;16;1319;1332;13;;
100;16;1332;1346;14;;
100;16;1346;1359;13;;
100;17;1359;1373;14;14,5;
100;17;1373;1388;15;;
100;17;1388;1402;14;;
100;17;1402;1417;15;;
100;17;1417;1431;14;;
100;17;1431;1446;15;;
100;17;1446;1460;14;;
100;17;1460;1475;15;;
100;17;1475;1489;14;;
100;17;1489;1504;15;;
100;18;1504;1519;15;15,6;
100;18;1519;1535;16;;
100;18;1535;1550;15;;
100;18;1550;1566;16;;
100;18;1566;1582;16;;
100;18;1582;1597;15;;
100;18;1597;1613;16;;
100;18;1613;1628;15;;
100;18;1628;1644;16;;
100;18;1644;1660;16;;
100;19;1660;1676;16;16,3;
100;19;1676;1693;17;;
100;19;1693;1709;16;;
100;19;1709;1726;17;;
100;19;1726;1742;16;;
100;19;1742;1758;16;;
100;19;1758;1774;16;;
100;19;1774;1791;17;;
100;19;1791;1807;16;;
100;19;1807;1823;16;;
100;20;1823;1840;17;17,6;
100;20;1840;1858;18;;
100;20;1858;1876;18;;
100;20;1876;1893;17;;
100;20;1893;1911;18;;
100;20;1911;1929;18;;
100;20;1929;1946;17;;
100;20;1946;1964;18;;
100;20;1964;1982;18;;
100;20;1982;1999;17;;
100;21;267;284;17;18;
100;21;284;302;18;;
100;21;302;321;19;;
100;21;321;338;17;;
100;21;338;356;18;;
100;21;356;374;18;;
100;21;374;392;18;;
100;21;392;411;19;;
100;21;411;429;18;;
100;21;429;447;18;;
100;22;447;466;19;18,8;
100;22;466;484;18;;
100;22;484;502;18;;
100;22;502;521;19;;
100;22;521;541;20;;
100;22;541;558;17;;
100;22;558;577;19;;
100;22;577;597;20;;
100;22;597;615;18;;
100;22;615;635;20;;
100;23;635;654;19;19,4;
100;23;654;671;17;;
100;23;671;689;18;;
100;23;689;709;20;;
100;23;709;730;21;;
100;23;730;752;22;;
100;23;752;771;19;;
100;23;771;790;19;;
100;23;790;809;19;;
100;23;809;829;20;;
100;24;829;849;20;20,4;
100;24;849;870;21;;
100;24;870;890;20;;
100;24;890;911;21;;
100;24;911;930;19;;
100;24;930;949;19;;
100;24;949;969;20;;
100;24;969;990;21;;
100;24;990;1012;22;;
100;24;1012;1033;21;;
100;25;1033;1054;21;21,7;
100;25;1054;1076;22;;
100;25;1076;1099;23;;
100;25;1099;1119;20;;
100;25;1119;1140;21;;
100;25;1140;1162;22;;
100;25;1162;1185;23;;
100;25;1185;1208;23;;
100;25;1208;1228;20;;
100;25;1228;1250;22;;
100;26;1250;1272;22;22,5;
100;26;1272;1295;23;;
100;26;1295;1317;22;;
100;26;1317;1341;24;;
100;26;1341;1363;22;;
100;26;1363;1385;22;;
100;26;1385;1409;24;;
100;26;1409;1431;22;;
100;26;1431;1454;23;;
100;26;1454;1475;21;;
100;27;1475;1498;23;23,6;
100;27;1498;1522;24;;
100;27;1522;1547;25;;
100;27;1547;1571;24;;
100;27;1571;1594;23;;
100;27;1594;1617;23;;
100;27;1617;1640;23;;
100;27;1640;1664;24;;
100;27;1664;1687;23;;
100;27;1687;1711;24;;
100;28;1711;1735;24;24,7;
100;28;1735;1760;25;;
100;28;1760;1784;24;;
100;28;1784;1809;25;;
100;28;1809;1835;26;;
100;28;1835;1860;25;;
100;28;1860;1884;24;;
100;28;1884;1909;25;;
100;28;1909;1933;24;;
100;28;1933;1958;25;;
100;29;1958;1983;25;25,4;
100;29;278;304;26;;
100;29;304;329;25;;
100;29;329;355;26;;
100;29;355;380;25;;
100;29;380;406;26;;
100;29;406;431;25;;
100;29;431;456;25;;
100;29;456;481;25;;
100;29;481;507;26;;
100;30;507;533;26;26,7;
100;30;533;560;27;;
100;30;560;587;27;;
100;30;587;615;28;;
100;30;615;641;26;;
100;30;641;667;26;;
100;30;667;694;27;;
100;30;694;720;26;;
100;30;720;748;28;;
100;30;748;774;26;;
100;31;774;799;25;26,6;
100;31;799;825;26;;
100;31;825;852;27;;
100;31;852;880;28;;
100;31;880;904;24;;
100;31;904;936;32;;
100;31;936;963;27;;
100;31;963;988;25;;
100;31;988;1014;26;;
100;31;1014;1040;26;;
100;32;1040;1065;25;28,5;
100;32;1065;1093;28;;
100;32;1093;1125;32;;
100;32;1125;1155;30;;
100;32;1155;1186;31;;
100;32;1186;1214;28;;
100;32;1214;1242;28;;
100;32;1242;1268;26;;
100;32;1268;1295;27;;
100;32;1295;1325;30;;
100;33;1325;1357;32;31,1;
100;33;1357;1389;32;;
100;33;1389;1418;29;;
100;33;1418;1450;32;;
100;33;1450;1482;32;;
100;33;1482;1509;27;;
100;33;1509;1540;31;;
100;33;1540;1574;34;;
100;33;1574;1604;30;;
100;33;1604;1636;32;;
100;34;1636;1667;31;31,4;
100;34;1667;1696;29;;
100;34;1696;1723;27;;
100;34;1723;1751;28;;
100;34;1751;1786;35;;
100;34;1786;1821;35;;
100;34;1821;1850;29;;
100;34;1850;1884;34;;
100;34;1884;1916;32;;
100;34;1916;1950;34;;
100;35;1950;1984;34;31,7;
100;35;256;289;33;;
100;35;289;318;29;;
100;35;318;349;31;;
100;35;349;382;33;;
100;35;382;412;30;;
100;35;412;445;33;;
100;35;445;479;34;;
100;35;479;507;28;;
100;35;507;539;32;;
100;36;539;574;35;32,8;
100;36;574;609;35;;
100;36;609;638;29;;
100;36;638;671;33;;
100;36;671;699;28;;
100;36;699;736;37;;
100;36;736;764;28;;
100;36;764;801;37;;
100;36;801;835;34;;
100;36;835;867;32;;
100;37;867;899;32;32,8;
100;37;899;930;31;;
100;37;930;959;29;;
100;37;959;990;31;;
100;37;990;1028;38;;
100;37;1028;1057;29;;
100;37;1057;1090;33;;
100;37;1090;1126;36;;
100;37;1126;1163;37;;
100;37;1163;1195;32;;
100;38;1195;1225;30;33,2;
100;38;1225;1261;36;;
100;38;1261;1290;29;;
100;38;1290;1324;34;;
100;38;1324;1359;35;;
100;38;1359;1396;37;;
100;38;1396;1425;29;;
100;38;1425;1456;31;;
100;38;1456;1489;33;;
100;38;1489;1527;38;;
100;39;1527;1558;31;33,7;
100;39;1558;1595;37;;
100;39;1595;1630;35;;
100;39;1630;1668;38;;
100;39;1668;1705;37;;
100;39;1705;1735;30;;
100;39;1735;1771;36;;
100;39;1771;1800;29;;
100;39;1800;1830;30;;
100;39;1830;1864;34;;
100;40;1864;1894;30;33,7;
100;40;1894;1925;31;;
100;40;1925;1957;32;;
100;40;1957;1996;39;;
100;40;276;314;38;;
100;40;314;345;31;;
100;40;345;379;34;;
100;40;379;409;30;;
100;40;409;447;38;;
100;40;447;481;34;;
100;41;481;518;37;36,2;
100;41;518;555;37;;
100;41;555;592;37;;
100;41;592;630;38;;
100;41;630;662;32;;
100;41;662;694;32;;
100;41;694;732;38;;
100;41;732;769;37;;
100;41;769;807;38;;
100;41;807;843;36;;
100;42;843;876;33;36,8;
100;42;876;918;42;;
100;42;918;957;39;;
100;42;957;994;37;;
100;42;994;1031;37;;
100;42;1031;1064;33;;
100;42;1064;1098;34;;
100;42;1098;1136;38;;
100;42;1136;1175;39;;
100;42;1175;1211;36;;
100;43;1211;1249;38;37,5;
100;43;1249;1290;41;;
100;43;1290;1326;36;;
100;43;1326;1364;38;;
100;43;1364;1398;34;;
100;43;1398;1437;39;;
100;43;1437;1477;40;;
100;43;1477;1519;42;;
100;43;1519;1553;34;;
100;43;1553;1586;33;;
100;44;1586;1621;35;38,2;
100;44;1621;1664;43;;
100;44;1664;1702;38;;
100;44;1702;1744;42;;
100;44;1744;1782;38;;
100;44;1782;1820;38;;
100;44;1820;1856;36;;
100;44;1856;1893;37;;
100;44;1893;1931;38;;
100;44;1931;1968;37;;
100;45;289;332;43;39,1;
100;45;332;372;40;;
100;45;372;411;39;;
100;45;411;455;44;;
100;45;455;491;36;;
100;45;491;525;34;;
100;45;525;563;38;;
100;45;563;602;39;;
100;45;602;646;44;;
100;45;646;680;34;;
100;46;680;724;44;40,1;
100;46;724;767;43;;
100;46;767;806;39;;
100;46;806;847;41;;
100;46;847;888;41;;
100;46;888;923;35;;
100;46;923;965;42;;
100;46;965;1001;36;;
100;46;1001;1041;40;;
100;46;1041;1081;40;;
100;47;1081;1117;36;40,4;
100;47;1117;1160;43;;
100;47;1160;1204;44;;
100;47;1204;1240;36;;
100;47;1240;1284;44;;
100;47;1284;1322;38;;
100;47;1322;1360;38;;
100;47;1360;1405;45;;
100;47;1405;1441;36;;
100;47;1441;1485;44;;
100;48;1485;1527;42;42,4;
100;48;1527;1572;45;;
100;48;1572;1613;41;;
100;48;1613;1652;39;;
100;48;1652;1697;45;;
100;48;1697;1737;40;;
100;48;1737;1781;44;;
100;48;1781;1823;42;;
100;48;1823;1865;42;;
100;48;1865;1909;44;;
100;49;1909;1954;45;43,9;
100;49;1954;2000;46;;
100;49;276;323;47;;
100;49;323;369;46;;
100;49;369;410;41;;
100;49;410;451;41;;
100;49;451;491;40;;
100;49;491;537;46;;
100;49;537;582;45;;
100;49;582;624;42;;
100;50;624;672;48;43,3;
100;50;672;712;40;;
100;50;712;756;44;;
100;50;756;803;47;;
100;50;803;845;42;;
100;50;845;889;44;;
100;50;889;929;40;;
100;50;929;972;43;;
100;50;972;1015;43;;
100;50;1015;1057;42;;
100;51;1057;1103;46;44,9;
100;51;1103;1150;47;;
100;51;1150;1194;44;;
100;51;1194;1243;49;;
100;51;1243;1285;42;;
100;51;1285;1330;45;;
100;51;1330;1373;43;;
100;51;1373;1417;44;;
100;51;1417;1459;42;;
100;51;1459;1506;47;;
100;52;1506;1551;45;43,6;
100;52;1551;1592;41;;
100;52;1592;1633;41;;
100;52;1633;1677;44;;
100;52;1677;1721;44;;
100;52;1721;1764;43;;
100;52;1764;1806;42;;
100;52;1806;1856;50;;
100;52;1856;1901;45;;
100;52;1901;1942;41;;
100;53;1942;1982;40;44,3;
100;53;256;303;47;;
100;53;303;349;46;;
100;53;349;396;47;;
100;53;396;440;44;;
100;53;440;483;43;;
100;53;483;523;40;;
100;53;523;570;47;;
100;53;570;613;43;;
100;53;613;659;46;;
100;54;659;702;43;44,7;
100;54;702;747;45;;
100;54;747;791;44;;
100;54;791;837;46;;
100;54;837;883;46;;
100;54;883;930;47;;
100;54;930;974;44;;
100;54;974;1016;42;;
100;54;1016;1058;42;;
100;54;1058;1106;48;;
100;55;1106;1156;50;46;
100;55;1156;1197;41;;
100;55;1197;1245;48;;
100;55;1245;1286;41;;
100;55;1286;1332;46;;
100;55;1332;1375;43;;
100;55;1375;1420;45;;
100;55;1420;1469;49;;
100;55;1469;1517;48;;
100;55;1517;1566;49;;
100;56;1566;1615;49;46,6;
100;56;1615;1660;45;;
100;56;1660;1703;43;;
100;56;1703;1747;44;;
100;56;1747;1796;49;;
100;56;1796;1841;45;;
100;56;1841;1890;49;;
100;56;1890;1939;49;;
100;56;1939;1984;45;;
100;56;252;300;48;;
100;57;300;349;49;47,5;
100;57;349;397;48;;
100;57;397;446;49;;
100;57;446;489;43;;
100;57;489;536;47;;
100;57;536;583;47;;
100;57;583;630;47;;
100;57;630;679;49;;
100;57;679;726;47;;
100;57;726;775;49;;
100;58;775;824;49;48,8;
100;58;824;871;47;;
100;58;871;915;44;;
100;58;915;968;53;;
100;58;968;1016;48;;
100;58;1016;1068;52;;
100;58;1068;1119;51;;
100;58;1119;1167;48;;
100;58;1167;1216;49;;
100;58;1216;1263;47;;
100;59;1263;1316;53;50,9;
100;59;1316;1366;50;;
100;59;1366;1419;53;;
100;59;1419;1473;54;;
100;59;1473;1520;47;;
100;59;1520;1568;48;;
100;59;1568;1614;46;;
100;59;1614;1667;53;;
100;59;1667;1720;53;;
100;59;1720;1772;52;;
100;60;1772;1821;49;50;
100;60;1821;1870;49;;
100;60;1870;1922;52;;
100;60;1922;1970;48;;
100;60;298;347;49;;
100;60;347;395;48;;
100;60;395;447;52;;
100;60;447;499;52;;
100;60;499;552;53;;
100;60;552;600;48;;
