Volume Tandon (L);Waktu (s);TDS Awal (ppm);TDS Akhir (ppm);Delta TDS (ppm);Rata Rata Delta TDS (ppm)
40;1;266;270;4;
40;1;270;275;5;
40;1;275;279;4;
40;1;279;283;4;
40;1;283;289;6;
40;1;289;293;4;
40;1;293;295;2;
40;1;295;301;6;
40;1;301;311;10;8,7
40;1;311;316;5;
40;2;316;328;12;
40;2;328;336;8;
40;2;336;342;6;
40;2;342;350;8;
40;2;350;363;13;
40;2;363;372;9;
40;2;372;381;9;
40;2;381;388;7;
40;2;388;403;15;12,3
40;2;403;416;13;
40;3;416;427;11;
40;3;427;441;14;
40;3;441;452;11;
40;3;452;466;14;
40;3;466;478;12;
40;3;478;488;10;
40;3;488;501;13;
40;3;501;511;10;
40;3;524;542;18;13,9
40;3;542;557;15;
40;4;557;570;13;
40;4;570;585;15;
40;4;585;599;14;
40;4;599;613;14;
40;4;613;623;10;
40;4;623;635;12;
40;4;635;649;14;
40;4;649;663;14;
40;4;663;682;19;12,2
40;4;682;697;15;
40;5;697;710;13;
40;5;710;720;10;
40;5;720;729;9;
40;5;729;737;8;
40;5;737;744;7;
40;5;744;758;14;
40;5;758;771;13;
40;5;771;785;14;
40;5;785;805;20;11,8
40;5;805;817;12;
40;6;817;831;14;
40;6;831;842;11;
40;6;842;847;5;
40;6;847;866;19;
40;6;866;873;7;
40;6;873;885;12;
40;6;885;893;8;
40;6;893;903;10;
40;6;903;915;12;14,9
40;6;915;923;8;
40;7;923;934;11;
40;7;934;942;8;
40;7;942;950;8;
40;7;950;957;7;
40;7;957;965;8;
40;7;965;994;29;
40;7;994;1022;28;
40;7;1022;1052;30;
40;7;1052;1084;32;29
40;7;1084;1115;31;
40;8;1115;1146;31;
40;8;1146;1180;34;
40;8;1180;1213;33;
40;8;1213;1231;18;
40;8;1231;1270;39;
40;8;1270;1304;34;
40;8;1304;1311;7;
40;8;1311;1342;31;
40;8;1342;1367;25;29,1
40;8;1367;1400;33;
40;9;1400;1428;28;
40;9;1428;1461;33;
40;9;1461;1489;28;
40;9;1489;1523;34;
40;9;1523;1548;25;
40;9;1548;1577;29;
40;9;1577;1603;26;
40;9;1603;1633;30;
40;9;1652;1706;54;47
40;9;1706;1751;45;
40;10;1751;1800;49;
40;10;1800;1848;48;
40;10;1848;1891;43;
40;10;1891;1938;47;
40;10;1938;1983;45;
40;10;240;284;44;
40;10;284;332;48;
40;10;332;379;47;
40;10;379;431;52;49,3
40;10;431;480;49;
40;11;480;531;51;
40;11;531;581;50;
40;11;581;631;50;
40;11;631;679;48;
40;11;679;728;49;
40;11;728;777;49;
40;11;777;829;52;
40;11;829;872;43;
40;11;872;925;53;51,7
40;11;925;978;53;
40;12;978;1030;52;
40;12;1030;1079;49;
40;12;1079;1132;53;
40;12;1132;1182;50;
40;12;1182;1236;54;
40;12;1236;1287;51;
40;12;1287;1338;51;
40;12;1338;1389;51;
40;12;1389;1446;57;53
40;12;1446;1501;55;
40;13;1501;1557;56;
40;13;1557;1613;56;
40;13;1613;1668;55;
40;13;1668;1723;55;
40;13;1723;1775;52;
40;13;1775;1820;45;
40;13;1820;1873;53;
40;13;1873;1919;46;
40;13;1919;1969;50;65,3
40;13;238;306;68;
40;14;306;375;69;
40;14;375;442;67;
40;14;442;509;67;
40;14;509;576;67;
40;14;576;643;67;
40;14;643;709;66;
40;14;709;775;66;
40;14;775;841;66;
40;14;907;978;71;68,8
40;14;978;1047;69;
40;15;1047;1116;69;
40;15;1193;1260;67;
40;15;1260;1330;70;
40;15;1330;1398;68;
40;15;1398;1469;71;
40;15;1469;1536;67;
40;15;1536;1604;68;
40;15;1604;1672;68;
40;15;1672;1744;72;78,3
40;15;1744;1817;73;
40;16;1817;1886;69;
40;16;1886;1957;71;
40;16;238;321;83;
40;16;321;406;85;
40;16;406;487;81;
40;16;487;571;84;
40;16;571;653;82;
40;16;653;736;83;
40;16;817;903;86;81,6
40;16;903;989;86;
40;17;989;1073;84;
40;17;1073;1158;85;
40;17;1158;1239;81;
40;17;1239;1319;80;
40;17;1319;1400;81;
40;17;1400;1479;79;
40;17;1479;1557;78;
40;17;1557;1633;76;
40;17;1633;1713;80;91,2
40;17;1713;1795;82;
40;18;1795;1878;83;
40;18;1878;1963;85;
40;18;241;341;100;
40;18;341;441;100;
40;18;441;535;94;
40;18;535;632;97;
40;18;632;729;97;
40;18;729;823;94;
40;18;823;921;98;94,2
40;18;921;1020;99;
40;19;1020;1115;95;
40;19;1115;1211;96;
40;19;1211;1300;89;
40;19;1300;1397;97;
40;19;1397;1489;92;
40;19;1489;1585;96;
40;19;1585;1676;91;
40;19;1676;1765;89;
40;19;1765;1859;94;95,7
40;19;1859;1950;91;
40;20;238;340;102;
40;20;340;441;101;
40;20;441;579;138;
40;20;579;638;59;
40;20;638;734;96;
40;20;734;825;91;
40;20;825;925;100;
40;20;925;1010;85;
40;20;257;374;117;112,5
40;20;374;488;114;
40;21;488;600;112;
40;21;600;714;114;
40;21;714;828;114;
40;21;828;940;112;
40;21;940;1051;111;
40;21;1051;1164;113;
40;21;1164;1273;109;
40;21;1273;1382;109;
40;21;1382;1496;114;120,8
40;21;1496;1609;113;
40;22;1609;1722;113;
40;22;1722;1833;111;
40;22;1833;1942;109;
40;22;269;392;123;
40;22;392;527;135;
40;22;527;659;132;
40;22;659;790;131;
40;22;790;917;127;
40;22;917;1050;133;130,3
40;22;1050;1181;131;
40;23;1181;1313;132;
40;23;1313;1440;127;
40;23;1440;1567;127;
40;23;1567;1693;126;
40;23;1693;1819;126;
40;23;1819;1943;124;
40;23;261;398;137;
40;23;398;538;140;
40;23;538;677;139;133,5
40;23;677;814;137;
40;24;814;951;137;
40;24;951;1088;137;
40;24;1088;1222;134;
40;24;1222;1351;129;
40;24;1351;1482;131;
40;24;1482;1613;131;
40;24;1613;1745;132;
40;24;1745;1873;128;
40;24;1873;1996;123;133,4
40;24;279;398;119;
40;25;398;526;128;
40;25;526;666;140;
40;25;666;805;139;
40;25;805;942;137;
40;25;942;1079;137;
40;25;1079;1215;136;
40;25;1215;1353;138;
40;25;1353;1490;137;
40;25;1490;1603;113;133,6
40;25;1603;1721;118;
40;26;1721;1850;129;
40;26;1850;1980;130;
40;26;250;390;140;
40;26;390;531;141;
40;26;531;673;142;
40;26;673;810;137;
40;26;810;952;142;
40;26;952;1096;144;
40;26;1096;1239;143;136,6
40;26;1239;1364;125;
40;27;1364;1478;114;
40;27;1478;1620;142;
40;27;1620;1761;141;
40;27;1761;1903;142;
40;27;280;420;140;
40;27;420;559;139;
40;27;559;699;140;
40;27;699;839;140;
40;27;839;958;119;139,6
40;27;958;1090;132;
40;28;1090;1224;134;
40;28;1224;1364;140;
40;28;1364;1505;141;
40;28;1505;1650;145;
40;28;1650;1797;147;
40;28;1797;1946;149;
40;28;260;405;145;
40;28;405;549;144;
40;28;549;673;124;141,3
40;28;673;795;122;
40;29;795;940;145;
40;29;940;1089;149;
40;29;1089;1237;148;
40;29;1237;1381;144;
40;29;1381;1526;145;
40;29;1526;1673;147;
40;29;1673;1818;145;
40;29;1818;1962;144;
40;29;269;411;142;145,7
40;29;411;554;143;
40;30;554;682;128;
40;30;682;827;145;
40;30;827;976;149;
40;30;976;1126;150;
40;30;1126;1277;151;
40;30;1277;1429;152;
40;30;1429;1578;149;
40;30;1578;1726;148;
40;30;1726;1876;150;150,6
40;30;267;416;149;
40;31;416;567;151;
40;31;567;717;150;
40;31;717;867;150;
40;31;867;1018;151;
40;31;1018;1170;152;
40;31;1170;1322;152;
40;31;1322;1473;151;
40;31;1473;1623;150;
40;31;1623;1776;153;154,6
40;31;1776;1930;154;
40;32;278;433;155;
40;32;433;587;154;
40;32;587;742;155;
40;32;742;897;155;
40;32;897;1051;154;
40;32;1051;1206;155;
40;32;1206;1361;155;
40;32;1361;1517;156;
40;32;1517;1664;147;146,9
40;32;1664;1810;146;
40;33;1810;1958;148;
40;33;265;410;145;
40;33;410;556;146;
40;33;556;703;147;
40;33;703;850;147;
40;33;850;998;148;
40;33;998;1145;147;
40;33;1145;1293;148;
40;33;1293;1449;156;151,7
40;33;1449;1607;158;
40;34;1607;1757;150;
40;34;1757;1908;151;
40;34;290;442;152;
40;34;442;595;153;
40;34;595;745;150;
40;34;745;894;149;
40;34;894;1043;149;
40;34;1043;1192;149;
40;34;1192;1352;160;156,1
40;34;1352;1511;159;
40;35;1511;1666;155;
40;35;1666;1820;154;
40;35;1820;1975;155;
40;35;256;412;156;
40;35;412;568;156;
40;35;568;725;157;
40;35;725;879;154;
40;35;879;1034;155;
40;35;1034;1194;160;159,6
40;35;1194;1354;160;
40;36;1354;1515;161;
40;36;1515;1677;162;
40;36;1677;1837;160;
40;36;1837;1996;159;
40;36;289;447;158;
40;36;447;606;159;
40;36;606;765;159;
40;36;765;923;158;
40;36;923;1083;160;166,2
40;36;1083;1258;175;
40;37;1258;1423;165;
40;37;1423;1588;165;
40;37;1588;1754;166;
40;37;1754;1918;164;
40;37;279;446;167;
40;37;446;612;166;
40;37;612;780;168;
40;37;780;946;166;
40;37;946;1113;167;167,7
40;37;1113;1278;165;
40;38;1278;1447;169;
40;38;1447;1615;168;
40;38;1615;1783;168;
40;38;1783;1952;169;
40;38;260;428;168;
40;38;428;597;169;
40;38;597;764;167;
40;38;764;931;167;
40;38;931;1116;185;174,2
40;38;1116;1299;183;
40;39;1299;1469;170;
40;39;1469;1640;171;
40;39;1640;1813;173;
40;39;1813;1986;173;
40;39;256;427;171;
40;39;427;599;172;
40;39;599;771;172;
40;39;771;943;172;
40;39;943;1122;179;176,3
40;39;1122;1298;176;
40;40;1298;1475;177;
40;40;1475;1649;174;
40;40;1649;1823;174;
40;40;1823;1998;175;
40;40;300;478;178;
40;40;478;655;177;
40;40;655;831;176;
40;40;831;1008;177;
40;40;1008;1187;179;180,8
40;40;1187;1367;180;
40;41;1367;1547;180;
40;41;1547;1728;181;
40;41;1728;1911;183;
40;41;312;495;183;
40;41;495;675;180;
40;41;675;857;182;
40;41;857;1036;179;
40;41;1036;1217;181;
40;41;1217;1398;181;183,3
40;41;1398;1583;185;
40;42;1583;1767;184;
40;42;1767;1949;182;
40;42;256;437;181;
40;42;437;623;186;
40;42;623;810;187;
40;42;810;994;184;
40;42;994;1176;182;
40;42;1176;1357;181;
40;42;1357;1545;188;186,8
40;42;1545;1730;185;
40;43;1730;1915;185;
40;43;257;446;189;
40;43;446;635;189;
40;43;635;820;185;
40;43;820;1006;186;
40;43;1006;1191;185;
40;43;1191;1379;188;
40;43;1379;1567;188;
40;43;1567;1761;194;193,1
40;43;1761;1956;195;
40;44;269;460;191;
40;44;460;651;191;
40;44;651;846;195;
40;44;846;1037;191;
40;44;1037;1230;193;
40;44;1230;1421;191;
40;44;1421;1616;195;
40;44;1616;1811;195;
40;44;270;466;196;196
40;44;466;661;195;
40;45;661;856;195;
40;45;856;1051;195;
40;45;1051;1247;196;
40;45;1247;1442;195;
40;45;1442;1638;196;
40;45;1638;1833;195;
40;45;273;472;199;
40;45;472;670;198;
40;45;670;873;203;201,3
40;45;873;1073;200;
40;46;1073;1277;204;
40;46;1277;1477;200;
40;46;1477;1680;203;
40;46;1680;1880;200;
40;46;256;460;204;
40;46;460;660;200;
40;46;660;860;200;
40;46;860;1059;199;
40;46;1059;1268;209;207,2
40;46;1268;1475;207;
40;47;1475;1680;205;
40;47;1680;1888;208;
40;47;270;479;209;
40;47;479;688;209;
40;47;688;894;206;
40;47;894;1102;208;
40;47;1102;1307;205;
40;47;1307;1513;206;
40;47;1513;1725;212;211,3
40;47;1725;1936;211;
40;48;280;492;212;
40;48;492;704;212;
40;48;704;913;209;
40;48;913;1125;212;
40;48;1125;1334;209;
40;48;1334;1546;212;
40;48;1546;1758;212;
40;48;1758;1970;212;
40;48;269;484;215;215,3
40;48;484;699;215;
40;49;699;917;218;
40;49;917;1134;217;
40;49;1134;1349;215;
40;49;1349;1562;213;
40;49;1562;1779;217;
40;49;1779;1991;212;
40;49;265;483;218;
40;49;483;696;213;
40;49;696;917;221;220,6
40;49;917;1137;220;
40;50;1137;1359;222;
40;50;1359;1577;218;
40;50;1577;1797;220;
40;50;275;498;223;
40;50;498;717;219;
40;50;717;940;223;
40;50;940;1158;218;
40;50;1158;1380;222;
40;50;1380;1605;225;224,3
40;50;1605;1830;225;
40;51;259;481;222;
40;51;481;707;226;
40;51;707;933;226;
40;51;933;1156;223;
40;51;1156;1379;223;
40;51;1379;1604;225;
40;51;1604;1829;225;
40;51;257;480;223;
40;51;480;707;227;228,6
40;51;707;938;231;
40;52;938;1165;227;
40;52;1165;1391;226;
40;52;1391;1622;231;
40;52;1622;1848;226;
40;52;290;521;231;
40;52;521;751;230;
40;52;751;980;229;
40;52;980;1208;228;
40;52;1208;1439;231;234,4
40;52;1439;1675;236;
40;53;1675;1910;235;
40;53;275;509;234;
40;53;509;745;236;
40;53;745;981;236;
40;53;981;1212;231;
40;53;1212;1448;236;
40;53;1448;1681;233;
40;53;1681;1917;236;
40;53;289;529;240;237,4
40;53;529;765;236;
40;54;765;1004;239;
40;54;1004;1243;239;
40;54;1243;1481;238;
40;54;1481;1717;236;
40;54;1717;1955;238;
40;54;287;524;237;
40;54;524;760;236;
40;54;760;995;235;
40;54;995;1237;242;242,5
40;54;1237;1481;244;
40;55;1481;1724;243;
40;55;1724;1968;244;
40;55;284;527;243;
40;55;527;771;244;
40;55;771;1015;244;
40;55;1015;1255;240;
40;55;1255;1495;240;
40;55;1495;1736;241;
40;55;1736;1982;246;245,9
40;55;259;507;248;
40;56;507;751;244;
40;56;751;995;244;
40;56;995;1241;246;
40;56;1241;1489;248;
40;56;1489;1737;248;
40;56;1737;1982;245;
40;56;271;515;244;
40;56;515;761;246;
40;56;761;1007;246;250,3
40;56;1007;1262;255;
40;57;1262;1510;248;
40;57;1510;1764;254;
40;57;290;544;254;
40;57;544;792;248;
40;57;792;1039;247;
40;57;1039;1285;246;
40;57;1285;1535;250;
40;57;1535;1790;255;
40;57;400;659;259;255,8
40;57;659;911;252;
40;58;911;1163;252;
40;58;1163;1423;260;
40;58;1423;1676;253;
40;58;1676;1932;256;
40;58;267;526;259;
40;58;526;783;257;
40;58;783;1038;255;
40;58;1038;1293;255;
40;58;1293;1557;264;260,2
40;58;1557;1817;260;
40;59;245;505;260;
40;59;505;768;263;
40;59;768;1027;259;
40;59;1027;1285;258;
40;59;1285;1544;259;
40;59;1544;1808;264;
40;59;231;486;255;
40;59;486;746;260;
40;59;746;1011;265;263,5
40;59;1011;1271;260;
40;60;1271;1532;261;
40;60;1532;1796;264;
40;60;289;556;267;
40;60;556;815;259;
40;60;815;1081;266;
40;60;1081;1345;264;
40;60;1345;1614;269;
40;60;1614;1874;260;
50;1;235;239;4;4,6
50;1;239;244;5;
50;1;244;248;4;
50;1;248;253;5;
50;1;253;257;4;
50;1;257;262;5;
50;1;262;263;1;
50;1;263;271;8;
50;1;271;276;5;
50;1;276;281;5;
50;2;281;288;7;8,6
50;2;288;298;10;
50;2;298;306;8;
50;2;306;314;8;
50;2;314;323;9;
50;2;323;332;9;
50;2;332;341;9;
50;2;341;350;9;
50;2;350;359;9;
50;2;359;367;8;
50;3;367;380;13;13,2
50;3;380;393;13;
50;3;393;407;14;
50;3;407;420;13;
50;3;420;433;13;
50;3;433;446;13;
50;3;446;459;13;
50;3;459;473;14;
50;3;473;486;13;
50;3;486;499;13;
50;4;499;516;17;16,7
50;4;516;533;17;
50;4;533;549;16;
50;4;549;566;17;
50;4;566;583;17;
50;4;583;600;17;
50;4;600;618;18;
50;4;618;633;15;
50;4;633;649;16;
50;4;649;666;17;
50;5;666;687;21;18,2
50;5;687;707;20;
50;5;707;726;19;
50;5;726;742;16;
50;5;742;751;9;
50;5;762;782;20;
50;5;782;803;21;
50;5;803;822;19;
50;5;822;840;18;
50;5;840;859;19;
50;6;859;879;20;22,4
50;6;879;905;26;
50;6;905;931;26;
50;6;931;954;23;
50;6;954;976;22;
50;6;976;997;21;
50;6;997;1017;20;
50;6;1017;1040;23;
50;6;1040;1062;22;
50;6;1062;1083;21;
50;7;1083;1114;31;29,2
50;7;1114;1145;31;
50;7;1145;1175;30;
50;7;1175;1205;30;
50;7;1205;1236;31;
50;7;1236;1265;29;
50;7;1265;1293;28;
50;7;1293;1318;25;
50;7;1318;1346;28;
50;7;1346;1375;29;
50;8;1375;1410;35;34,8
50;8;1410;1444;34;
50;8;1444;1478;34;
50;8;1478;1511;33;
50;8;1511;1546;35;
50;8;1546;1582;36;
50;8;1582;1616;34;
50;8;1616;1652;36;
50;8;1652;1687;35;
50;8;1687;1723;36;
50;9;1723;1761;38;37,3
50;9;1761;1799;38;
50;9;1799;1837;38;
50;9;1837;1873;36;
50;9;1873;1910;37;
50;9;1910;1945;35;
50;9;240;278;38;
50;9;278;316;38;
50;9;316;355;39;
50;9;355;391;36;
50;10;391;432;41;41
50;10;432;474;42;
50;10;474;516;42;
50;10;516;556;40;
50;10;556;599;43;
50;10;599;639;40;
50;10;639;678;39;
50;10;678;716;38;
50;10;716;759;43;
50;10;759;801;42;
50;11;801;847;46;45
50;11;847;892;45;
50;11;892;937;45;
50;11;937;981;44;
50;11;981;1024;43;
50;11;1024;1070;46;
50;11;1070;1117;47;
50;11;1117;1160;43;
50;11;1160;1206;46;
50;11;1206;1251;45;
50;12;1251;1301;50;49,2
50;12;1301;1348;47;
50;12;1348;1396;48;
50;12;1396;1445;49;
50;12;1445;1493;48;
50;12;1493;1543;50;
50;12;1543;1594;51;
50;12;1594;1646;52;
50;12;1646;1695;49;
50;12;1695;1743;48;
50;13;1743;1795;52;53,9
50;13;1795;1848;53;
50;13;1848;1899;51;
50;13;1899;1954;55;
50;13;260;316;56;
50;13;316;369;53;
50;13;369;423;54;
50;13;423;477;54;
50;13;477;532;55;
50;13;532;588;56;
50;14;588;644;56;56,9
50;14;644;697;53;
50;14;697;751;54;
50;14;751;808;57;
50;14;808;866;58;
50;14;866;924;58;
50;14;924;983;59;
50;14;983;1042;59;
50;14;1042;1100;58;
50;14;1100;1157;57;
50;15;1157;1215;58;59,2
50;15;1215;1272;57;
50;15;1272;1330;58;
50;15;1330;1389;59;
50;15;1389;1449;60;
50;15;1449;1510;61;
50;15;1510;1569;59;
50;15;1569;1627;58;
50;15;1627;1687;60;
50;15;1687;1749;62;
50;16;1749;1816;67;64,8
50;16;1816;1906;90;
50;16;1906;1971;65;
50;16;259;319;60;
50;16;319;381;62;
50;16;381;442;61;
50;16;442;504;62;
50;16;504;564;60;
50;16;564;625;61;
50;16;625;685;60;
50;17;685;752;67;68,2
50;17;752;820;68;
50;17;820;888;68;
50;17;888;957;69;
50;17;957;1025;68;
50;17;1025;1092;67;
50;17;1092;1160;68;
50;17;1160;1229;69;
50;17;1229;1298;69;
50;17;1298;1367;69;
50;18;1367;1440;73;71,4
50;18;1440;1508;68;
50;18;1508;1577;69;
50;18;1577;1649;72;
50;18;1649;1722;73;
50;18;1722;1794;72;
50;18;1794;1865;71;
50;18;1865;1936;71;
50;18;257;329;72;
50;18;329;402;73;
50;19;402;478;76;75
50;19;478;544;66;
50;19;544;616;72;
50;19;616;691;75;
50;19;691;767;76;
50;19;767;844;77;
50;19;844;918;74;
50;19;918;995;77;
50;19;995;1073;78;
50;19;1073;1152;79;
50;20;1152;1227;75;79,1
50;20;1227;1302;75;
50;20;1302;1375;73;
50;20;1375;1454;79;
50;20;1454;1536;82;
50;20;1536;1617;81;
50;20;1617;1702;85;
50;20;1702;1782;80;
50;20;1782;1863;81;
50;20;1863;1943;80;
50;21;1943;1998;55;82,7
50;21;267;367;100;
50;21;367;450;83;
50;21;450;534;84;
50;21;534;619;85;
50;21;619;704;85;
50;21;704;793;89;
50;21;793;874;81;
50;21;874;956;82;
50;21;956;1039;83;
50;22;1039;1119;80;86,3
50;22;1119;1196;77;
50;22;1196;1273;77;
50;22;1273;1361;88;
50;22;1361;1450;89;
50;22;1450;1541;91;
50;22;1541;1633;92;
50;22;1633;1722;89;
50;22;1722;1812;90;
50;22;1812;1902;90;
50;23;1902;1997;95;91,1
50;23;259;353;94;
50;23;353;453;100;
50;23;453;538;85;
50;23;538;626;88;
50;23;626;713;87;
50;23;713;801;88;
50;23;801;896;95;
50;23;896;985;89;
50;23;985;1075;90;
50;24;1075;1172;97;95,1
50;24;1172;1265;93;
50;24;1265;1360;95;
50;24;1360;1458;98;
50;24;1458;1555;97;
50;24;1555;1650;95;
50;24;1650;1746;96;
50;24;1746;1838;92;
50;24;1838;1931;93;
50;24;256;351;95;
50;25;351;446;95;96,2
50;25;446;541;95;
50;25;541;614;73;
50;25;614;713;99;
50;25;713;811;98;
50;25;811;910;99;
50;25;910;1010;100;
50;25;1010;1111;101;
50;25;1111;1213;102;
50;25;1213;1313;100;
50;26;1313;1414;101;103,5
50;26;1414;1516;102;
50;26;1516;1614;98;
50;26;1614;1719;105;
50;26;1719;1822;103;
50;26;1822;1926;104;
50;26;289;394;105;
50;26;394;500;106;
50;26;500;607;107;
50;26;607;711;104;
50;27;711;810;99;106,2
50;27;810;914;104;
50;27;914;1011;97;
50;27;1011;1118;107;
50;27;1118;1226;108;
50;27;1226;1336;110;
50;27;1336;1447;111;
50;27;1447;1556;109;
50;27;1556;1664;108;
50;27;1664;1773;109;
50;28;1773;1870;97;108,2
50;28;1870;1976;106;
50;28;300;396;96;
50;28;396;506;110;
50;28;506;618;112;
50;28;618;731;113;
50;28;731;843;112;
50;28;843;954;111;
50;28;954;1066;112;
50;28;1066;1179;113;
50;29;1179;1283;104;110,5
50;29;1283;1379;96;
50;29;1379;1480;101;
50;29;1480;1596;116;
50;29;1596;1709;113;
50;29;1709;1823;114;
50;29;1823;1938;115;
50;29;276;391;115;
50;29;391;505;114;
50;29;505;622;117;
50;30;622;741;119;116,6
50;30;741;864;123;
50;30;864;988;124;
50;30;988;1102;114;
50;30;1102;1215;113;
50;30;1215;1330;115;
50;30;1330;1443;113;
50;30;1443;1557;114;
50;30;1557;1672;115;
50;30;1672;1788;116;
50;31;1788;1909;121;120,6
50;31;290;410;120;
50;31;410;528;118;
50;31;528;650;122;
50;31;650;767;117;
50;31;767;892;125;
50;31;892;1014;122;
50;31;1014;1134;120;
50;31;1134;1255;121;
50;31;1255;1375;120;
50;32;1375;1496;121;124,7
50;32;1496;1622;126;
50;32;1622;1749;127;
50;32;1749;1879;130;
50;32;278;400;122;
50;32;400;526;126;
50;32;526;653;127;
50;32;653;776;123;
50;32;776;897;121;
50;32;897;1021;124;
50;33;1021;1148;127;131,6
50;33;1148;1282;134;
50;33;1282;1412;130;
50;33;1412;1544;132;
50;33;1544;1677;133;
50;33;1677;1811;134;
50;33;1811;1943;132;
50;33;256;384;128;
50;33;287;419;132;
50;33;419;553;134;
50;34;553;689;136;137,6
50;34;689;826;137;
50;34;826;964;138;
50;34;964;1105;141;
50;34;1105;1244;139;
50;34;1244;1381;137;
50;34;1381;1517;136;
50;34;1517;1658;141;
50;34;1658;1790;132;
50;34;1790;1929;139;
50;35;276;422;146;142,2
50;35;422;566;144;
50;35;566;712;146;
50;35;712;854;142;
50;35;854;992;138;
50;35;992;1134;142;
50;35;1134;1272;138;
50;35;1272;1415;143;
50;35;1415;1559;144;
50;35;1559;1698;139;
50;36;1698;1849;151;146
50;36;1849;1991;142;
50;36;256;407;151;
50;36;407;550;143;
50;36;550;695;145;
50;36;695;839;144;
50;36;839;982;143;
50;36;982;1126;144;
50;36;1126;1273;147;
50;36;1273;1423;150;
50;37;1423;1572;149;150,3
50;37;1572;1722;150;
50;37;1722;1872;150;
50;37;283;430;147;
50;37;430;585;155;
50;37;585;738;153;
50;37;738;886;148;
50;37;886;1038;152;
50;37;1038;1185;147;
50;37;1185;1337;152;
50;38;1337;1490;153;155,2
50;38;1490;1643;153;
50;38;1643;1802;159;
50;38;1802;1957;155;
50;38;288;444;156;
50;38;444;599;155;
50;38;599;752;153;
50;38;752;905;153;
50;38;905;1063;158;
50;38;1063;1220;157;
50;39;1220;1381;161;158,5
50;39;1381;1541;160;
50;39;1541;1697;156;
50;39;1697;1852;155;
50;39;314;477;163;
50;39;477;635;158;
50;39;635;791;156;
50;39;791;947;156;
50;39;947;1110;163;
50;39;1110;1267;157;
50;40;1267;1432;165;163,3
50;40;1432;1599;167;
50;40;1599;1767;168;
50;40;1767;1933;166;
50;40;245;404;159;
50;40;404;570;166;
50;40;570;731;161;
50;40;731;890;159;
50;40;890;1050;160;
50;40;1050;1212;162;
50;41;1212;1375;163;165,6
50;41;1375;1539;164;
50;41;1539;1706;167;
50;41;1706;1878;172;
50;41;287;450;163;
50;41;450;619;169;
50;41;619;784;165;
50;41;784;948;164;
50;41;948;1111;163;
50;41;1111;1277;166;
50;42;1277;1449;172;171,2
50;42;1449;1617;168;
50;42;1617;1790;173;
50;42;245;412;167;
50;42;412;587;175;
50;42;587;762;175;
50;42;762;929;167;
50;42;929;1102;173;
50;42;1102;1276;174;
50;42;1276;1444;168;
50;43;1444;1619;175;175,9
50;43;1619;1790;171;
50;43;289;461;172;
50;43;461;638;177;
50;43;638;816;178;
50;43;816;995;179;
50;43;995;1173;178;
50;43;1173;1348;175;
50;43;1348;1525;177;
50;43;1525;1702;177;
50;44;1702;1884;182;180,1
50;44;304;482;178;
50;44;482;665;183;
50;44;665;844;179;
50;44;844;1025;181;
50;44;1025;1205;180;
50;44;1205;1389;184;
50;44;1389;1565;176;
50;44;1565;1742;177;
50;44;1742;1923;181;
50;45;290;470;180;182,6
50;45;470;654;184;
50;45;654;834;180;
50;45;834;1016;182;
50;45;1016;1197;181;
50;45;1197;1383;186;
50;45;1383;1564;181;
50;45;1564;1751;187;
50;45;1751;1933;182;
50;45;278;461;183;
50;46;461;653;192;186,7
50;46;653;836;183;
50;46;836;1019;183;
50;46;1019;1203;184;
50;46;1203;1392;189;
50;46;1392;1576;184;
50;46;1576;1766;190;
50;46;290;479;189;
50;46;479;665;186;
50;46;665;852;187;
50;47;852;1044;192;191,9
50;47;1044;1234;190;
50;47;1234;1426;192;
50;47;1426;1619;193;
50;47;1619;1813;194;
50;47;278;472;194;
50;47;472;663;191;
50;47;663;859;196;
50;47;859;1048;189;
50;47;1048;1236;188;
50;48;1236;1433;197;196,7
50;48;1433;1633;200;
50;48;1633;1831;198;
50;48;278;471;193;
50;48;471;665;194;
50;48;665;865;200;
50;48;865;1060;195;
50;48;1060;1259;199;
50;48;1259;1454;195;
50;48;1454;1650;196;
50;49;1650;1848;198;201,4
50;49;312;514;202;
50;49;514;720;206;
50;49;720;925;205;
50;49;925;1128;203;
50;49;1128;1331;203;
50;49;1331;1533;202;
50;49;1533;1732;199;
50;49;1732;1931;199;
50;49;290;487;197;
50;50;487;695;208;206,3
50;50;695;905;210;
50;50;905;1108;203;
50;50;1108;1313;205;
50;50;1313;1515;202;
50;50;1515;1725;210;
50;50;1725;1931;206;
50;50;275;480;205;
50;50;480;691;211;
50;50;691;894;203;
50;51;894;1103;209;210,7
50;51;1103;1316;213;
50;51;1316;1527;211;
50;51;1527;1741;214;
50;51;1741;1952;211;
50;51;289;503;214;
50;51;503;712;209;
50;51;712;921;209;
50;51;921;1128;207;
50;51;1128;1338;210;
50;52;1338;1555;217;214,9
50;52;1555;1772;217;
50;52;278;489;211;
50;52;489;707;218;
50;52;707;921;214;
50;52;921;1137;216;
50;52;1137;1348;211;
50;52;1348;1566;218;
50;52;1566;1777;211;
50;52;300;516;216;
50;53;516;732;216;218,9
50;53;732;955;223;
50;53;955;1173;218;
50;53;1173;1393;220;
50;53;1393;1616;223;
50;53;1616;1835;219;
50;53;290;510;220;
50;53;510;725;215;
50;53;725;943;218;
50;53;943;1160;217;
50;54;1160;1382;222;224,2
50;54;1382;1609;227;
50;54;1609;1832;223;
50;54;290;515;225;
50;54;515;743;228;
50;54;743;962;219;
50;54;962;1187;225;
50;54;1187;1410;223;
50;54;1410;1632;222;
50;54;1632;1860;228;
50;55;262;490;228;228,9
50;55;490;719;229;
50;55;719;947;228;
50;55;947;1174;227;
50;55;1174;1405;231;
50;55;1405;1630;225;
50;55;1630;1861;231;
50;55;266;499;233;
50;55;499;725;226;
50;55;725;956;231;
50;56;956;1191;235;233,6
50;56;1191;1420;229;
50;56;1420;1654;234;
50;56;1654;1890;236;
50;56;309;545;236;
50;56;545;774;229;
50;56;774;1009;235;
50;56;1009;1243;234;
50;56;1243;1479;236;
50;56;1479;1711;232;
50;57;1711;1949;238;237,7
50;57;278;512;234;
50;57;512;754;242;
50;57;754;991;237;
50;57;991;1232;241;
50;57;1232;1466;234;
50;57;1466;1706;240;
50;57;1706;1943;237;
50;57;293;530;237;
50;57;530;767;237;
50;58;767;1008;241;242,3
50;58;1008;1248;240;
50;58;1248;1487;239;
50;58;1487;1729;242;
50;58;285;528;243;
50;58;528;771;243;
50;58;771;1018;247;
50;58;1018;1259;241;
50;58;1259;1504;245;
50;58;1504;1746;242;
50;59;314;562;248;247,2
50;59;562;804;242;
50;59;804;1054;250;
50;59;1054;1296;242;
50;59;1296;1538;242;
50;59;1538;1788;250;
50;59;264;510;246;
50;59;510;760;250;
50;59;760;1011;251;
50;59;1011;1262;251;
50;60;1262;1517;255;251,5
50;60;1517;1768;251;
50;60;271;520;249;
50;60;520;770;250;
50;60;770;1025;255;
50;60;1025;1280;255;
50;60;1280;1534;254;
50;60;1534;1784;250;
50;60;290;537;247;
50;60;537;786;249;
60;1;1281;1290;9;5,2
60;1;1290;1299;9;
60;1;1299;1304;5;
60;1;1304;1310;6;
60;1;1310;1312;2;
60;1;1312;1315;3;
60;1;1315;1320;5;
60;1;1320;1325;5;
60;1;1325;1326;1;
60;1;1326;1333;7;
60;2;1333;1335;2;6,5
60;2;1335;1344;9;
60;2;1344;1349;5;
60;2;1349;1353;4;
60;2;1353;1363;10;
60;2;1363;1370;7;
60;2;1370;1374;4;
60;2;1374;1383;9;
60;2;1383;1392;9;
60;2;1392;1398;6;
60;3;1398;1406;8;9,6
60;3;1406;1409;3;
60;3;1409;1421;12;
60;3;1421;1433;12;
60;3;1433;1446;13;
60;3;1446;1457;11;
60;3;1457;1469;12;
60;3;1469;1474;5;
60;3;1474;1485;11;
60;3;1485;1494;9;
60;4;1494;1508;14;13,1
60;4;1508;1520;12;
60;4;1520;1535;15;
60;4;1535;1550;15;
60;4;1550;1562;12;
60;4;1562;1575;13;
60;4;1575;1589;14;
60;4;1589;1602;13;
60;4;1602;1618;16;
60;4;1618;1625;7;
60;5;1625;1644;19;16,8
60;5;1644;1654;10;
60;5;1654;1679;25;
60;5;1679;1695;16;
60;5;1695;1709;14;
60;5;1709;1728;19;
60;5;1728;1743;15;
60;5;1743;1760;17;
60;5;1760;1777;17;
60;5;1777;1793;16;
60;6;1793;1812;19;21,9
60;6;1812;1829;17;
60;6;1829;1851;22;
60;6;1851;1874;23;
60;6;1874;1898;24;
60;6;1898;1923;25;
60;6;1923;1946;23;
60;6;1946;1968;22;
60;6;1968;1990;22;
60;6;260;282;22;
60;7;282;304;22;24
60;7;304;327;23;
60;7;327;348;21;
60;7;348;372;24;
60;7;372;398;26;
60;7;398;425;27;
60;7;425;447;22;
60;7;447;472;25;
60;7;472;496;24;
60;7;496;522;26;
60;8;522;534;12;27,6
60;8;534;578;44;
60;8;578;603;25;
60;8;603;630;27;
60;8;630;658;28;
60;8;658;686;28;
60;8;686;715;29;
60;8;715;742;27;
60;8;742;770;28;
60;8;770;798;28;
60;9;798;824;26;30,4
60;9;824;854;30;
60;9;854;886;32;
60;9;886;917;31;
60;9;917;946;29;
60;9;946;979;33;
60;9;979;1009;30;
60;9;1009;1038;29;
60;9;1038;1070;32;
60;9;1070;1102;32;
60;10;1102;1134;32;33,2
60;10;1134;1163;29;
60;10;1163;1198;35;
60;10;1198;1233;35;
60;10;1233;1267;34;
60;10;1267;1300;33;
60;10;1300;1332;32;
60;10;1332;1364;32;
60;10;1364;1399;35;
60;10;1399;1434;35;
60;11;1434;1469;35;35
60;11;1469;1501;32;
60;11;1501;1539;38;
60;11;1539;1575;36;
60;11;1575;1610;35;
60;11;1610;1644;34;
60;11;1644;1677;33;
60;11;1677;1713;36;
60;11;1713;1749;36;
60;11;1749;1784;35;
60;12;1784;1822;38;39
60;12;1822;1859;37;
60;12;1859;1898;39;
60;12;1898;1936;38;
60;12;1936;1975;39;
60;12;255;295;40;
60;12;295;336;41;
60;12;336;376;40;
60;12;376;415;39;
60;12;415;454;39;
60;13;454;493;39;41,5
60;13;493;533;40;
60;13;533;572;39;
60;13;572;614;42;
60;13;614;655;41;
60;13;655;698;43;
60;13;698;742;44;
60;13;742;784;42;
60;13;784;827;43;
60;13;827;869;42;
60;14;869;912;43;44
60;14;912;959;47;
60;14;959;1001;42;
60;14;1001;1046;45;
60;14;1046;1092;46;
60;14;1092;1136;44;
60;14;1136;1181;45;
60;14;1181;1223;42;
60;14;1223;1265;42;
60;14;1265;1309;44;
60;15;1309;1354;45;47,1
60;15;1354;1400;46;
60;15;1400;1445;45;
60;15;1445;1492;47;
60;15;1492;1540;48;
60;15;1540;1589;49;
60;15;1589;1636;47;
60;15;1636;1684;48;
60;15;1684;1731;47;
60;15;1731;1780;49;
60;16;1780;1828;48;52,1
60;16;1828;1877;49;
60;16;1877;1927;50;
60;16;1927;1980;53;
60;16;289;343;54;
60;16;343;398;55;
60;16;398;448;50;
60;16;448;501;53;
60;16;501;556;55;
60;16;556;610;54;
60;17;610;665;55;56
60;17;665;717;52;
60;17;717;769;52;
60;17;769;825;56;
60;17;825;882;57;
60;17;882;940;58;
60;17;940;996;56;
60;17;996;1053;57;
60;17;1053;1111;58;
60;17;1111;1170;59;
60;18;1170;1226;56;60
60;18;1226;1279;53;
60;18;1279;1335;56;
60;18;1335;1395;60;
60;18;1395;1459;64;
60;18;1459;1520;61;
60;18;1520;1582;62;
60;18;1582;1645;63;
60;18;1645;1709;64;
60;18;1709;1770;61;
60;19;1770;1826;56;64,9
60;19;1826;1891;65;
60;19;1891;1949;58;
60;19;246;313;67;
60;19;313;381;68;
60;19;381;450;69;
60;19;450;516;66;
60;19;516;583;67;
60;19;583;651;68;
60;19;651;716;65;
60;20;716;794;78;72,8
60;20;794;863;69;
60;20;863;931;68;
60;20;931;1005;74;
60;20;1005;1080;75;
60;20;1080;1156;76;
60;20;1156;1226;70;
60;20;1226;1297;71;
60;20;1297;1370;73;
60;20;1370;1444;74;
60;21;1444;1521;77;78,8
60;21;1521;1601;80;
60;21;1601;1683;82;
60;21;1683;1766;83;
60;21;1766;1845;79;
60;21;1845;1922;77;
60;21;290;368;78;
60;21;368;438;70;
60;21;438;517;79;
60;21;517;600;83;
60;22;600;680;80;76
60;22;680;759;79;
60;22;759;845;86;
60;22;845;932;87;
60;22;932;1014;82;
60;22;1014;1020;6;
60;22;1020;1108;88;
60;22;1108;1193;85;
60;22;1193;1281;88;
60;22;1281;1360;79;
60;23;1360;1449;89;87,5
60;23;1449;1532;83;
60;23;1532;1603;71;
60;23;1603;1693;90;
60;23;1693;1788;95;
60;23;1788;1875;87;
60;23;1875;1963;88;
60;23;293;386;93;
60;23;386;475;89;
60;23;475;565;90;
60;24;565;655;90;93,6
60;24;655;748;93;
60;24;748;842;94;
60;24;842;938;96;
60;24;938;1033;95;
60;24;1033;1127;94;
60;24;1127;1219;92;
60;24;1219;1312;93;
60;24;1312;1406;94;
60;24;1406;1501;95;
60;25;1501;1600;99;99,3
60;25;1600;1700;100;
60;25;1700;1794;94;
60;25;1794;1896;102;
60;25;1896;1999;103;
60;25;256;356;100;
60;25;356;455;99;
60;25;455;552;97;
60;25;552;652;100;
60;25;652;751;99;
60;26;751;851;100;105,4
60;26;851;957;106;
60;26;957;1065;108;
60;26;1065;1169;104;
60;26;1169;1272;103;
60;26;1272;1376;104;
60;26;1376;1481;105;
60;26;1481;1588;107;
60;26;1588;1696;108;
60;26;1696;1805;109;
60;27;1805;1917;112;111,7
60;27;275;389;114;
60;27;389;504;115;
60;27;504;613;109;
60;27;613;724;111;
60;27;724;836;112;
60;27;836;949;113;
60;27;949;1058;109;
60;27;1058;1168;110;
60;27;1168;1280;112;
60;28;1280;1399;119;116,3
60;28;1399;1517;118;
60;28;1517;1637;120;
60;28;1637;1756;119;
60;28;1756;1873;117;
60;28;1873;1988;115;
60;28;289;403;114;
60;28;403;517;114;
60;28;517;630;113;
60;28;630;744;114;
60;29;744;868;124;123,9
60;29;868;993;125;
60;29;993;1121;128;
60;29;1121;1248;127;
60;29;1248;1370;122;
60;29;1370;1490;120;
60;29;1490;1616;126;
60;29;1616;1741;125;
60;29;1741;1861;120;
60;29;1861;1983;122;
60;30;319;449;130;128,6
60;30;449;574;125;
60;30;574;700;126;
60;30;700;826;126;
60;30;826;955;129;
60;30;955;1083;128;
60;30;1083;1214;131;
60;30;1214;1346;132;
60;30;1346;1476;130;
60;30;1476;1605;129;
60;31;1605;1742;137;133,7
60;31;1742;1872;130;
60;31;267;403;136;
60;31;403;539;136;
60;31;539;669;130;
60;31;669;800;131;
60;31;800;931;131;
60;31;931;1068;137;
60;31;1068;1201;133;
60;31;1201;1337;136;
60;32;1337;1473;136;138,4
60;32;1473;1612;139;
60;32;1612;1749;137;
60;32;1749;1888;139;
60;32;298;434;136;
60;32;434;569;135;
60;32;569;712;143;
60;32;712;851;139;
60;32;851;989;138;
60;32;989;1131;142;
60;33;1131;1272;141;143
60;33;1272;1411;139;
60;33;1411;1554;143;
60;33;1554;1700;146;
60;33;1700;1841;141;
60;33;290;433;143;
60;33;433;578;145;
60;33;578;725;147;
60;33;725;870;145;
60;33;870;1010;140;
60;34;1010;1159;149;148,9
60;34;1159;1310;151;
60;34;1310;1455;145;
60;34;1455;1601;146;
60;34;1601;1752;151;
60;34;1752;1905;153;
60;34;245;394;149;
60;34;394;539;145;
60;34;539;691;152;
60;34;691;839;148;
60;35;839;998;159;154,5
60;35;998;1150;152;
60;35;1150;1302;152;
60;35;1302;1454;152;
60;35;1454;1608;154;
60;35;1608;1763;155;
60;35;1763;1915;152;
60;35;272;427;155;
60;35;427;583;156;
60;35;583;741;158;
60;36;741;900;159;159,4
60;36;900;1055;155;
60;36;1055;1213;158;
60;36;1213;1372;159;
60;36;1372;1533;161;
60;36;1533;1695;162;
60;36;1695;1852;157;
60;36;287;450;163;
60;36;450;608;158;
60;36;608;770;162;
60;37;770;937;167;164,2
60;37;937;1104;167;
60;37;1104;1267;163;
60;37;1267;1434;167;
60;37;1434;1602;168;
60;37;1602;1763;161;
60;37;1763;1923;160;
60;37;289;449;160;
60;37;449;609;160;
60;37;609;778;169;
60;38;778;945;167;169,5
60;38;945;1117;172;
60;38;1117;1289;172;
60;38;1289;1463;174;
60;38;1463;1635;172;
60;38;1635;1805;170;
60;38;245;410;165;
60;38;410;577;167;
60;38;577;747;170;
60;38;747;913;166;
60;39;913;1085;172;174,9
60;39;1085;1264;179;
60;39;1264;1443;179;
60;39;1443;1620;177;
60;39;1620;1794;174;
60;39;1794;1966;172;
60;39;289;462;173;
60;39;462;638;176;
60;39;638;815;177;
60;39;815;985;170;
60;40;985;1164;179;180,9
60;40;1164;1341;177;
60;40;1341;1524;183;
60;40;1524;1704;180;
60;40;1704;1885;181;
60;40;294;474;180;
60;40;474;651;177;
60;40;651;836;185;
60;40;836;1019;183;
60;40;1019;1203;184;
60;41;1203;1387;184;185,8
60;41;1387;1577;190;
60;41;1577;1761;184;
60;41;1761;1944;183;
60;41;273;463;190;
60;41;463;647;184;
60;41;647;835;188;
60;41;835;1021;186;
60;41;1021;1203;182;
60;41;1203;1390;187;
60;42;1390;1584;194;192
60;42;1584;1780;196;
60;42;1780;1975;195;
60;42;287;479;192;
60;42;479;671;192;
60;42;671;864;193;
60;42;864;1053;189;
60;42;1053;1240;187;
60;42;1240;1432;192;
60;42;1432;1622;190;
60;43;1622;1822;200;197,5
60;43;265;460;195;
60;43;460;658;198;
60;43;658;856;198;
60;43;856;1053;197;
60;43;1053;1249;196;
60;43;1249;1448;199;
60;43;1448;1648;200;
60;43;1648;1841;193;
60;43;254;453;199;
60;44;453;653;200;203,7
60;44;653;859;206;
60;44;859;1064;205;
60;44;1064;1265;201;
60;44;1265;1463;198;
60;44;1463;1669;206;
60;44;1669;1874;205;
60;44;276;483;207;
60;44;483;686;203;
60;44;686;892;206;
60;45;892;1096;204;208,9
60;45;1096;1304;208;
60;45;1304;1515;211;
60;45;1515;1727;212;
60;45;1727;1931;204;
60;45;287;493;206;
60;45;493;704;211;
60;45;704;912;208;
60;45;912;1124;212;
60;45;1124;1337;213;
60;46;1337;1553;216;214,1
60;46;1553;1763;210;
60;46;1763;1977;214;
60;46;276;490;214;
60;46;490;707;217;
60;46;707;919;212;
60;46;919;1133;214;
60;46;1133;1347;214;
60;46;1347;1558;211;
60;46;1558;1777;219;
60;47;1777;1998;221;220,7
60;47;278;502;224;
60;47;502;726;224;
60;47;726;949;223;
60;47;949;1172;223;
60;47;1172;1391;219;
60;47;1391;1609;218;
60;47;1609;1830;221;
60;47;268;484;216;
60;47;484;702;218;
60;48;702;929;227;225,3
60;48;929;1152;223;
60;48;1152;1382;230;
60;48;1382;1605;223;
60;48;1605;1832;227;
60;48;262;486;224;
60;48;486;715;229;
60;48;715;938;223;
60;48;938;1162;224;
60;48;1162;1385;223;
60;49;1385;1612;227;231
60;49;1612;1842;230;
60;49;245;477;232;
60;49;477;707;230;
60;49;707;934;227;
60;49;934;1160;226;
60;49;1160;1394;234;
60;49;1394;1628;234;
60;49;1628;1863;235;
60;49;278;513;235;
60;50;513;749;236;235,9
60;50;749;985;236;
60;50;985;1218;233;
60;50;1218;1452;234;
60;50;1452;1685;233;
60;50;1685;1921;236;
60;50;301;541;240;
60;50;541;780;239;
60;50;780;1017;237;
60;50;1017;1252;235;
60;51;1252;1489;237;242,3
60;51;1489;1730;241;
60;51;1730;1976;246;
60;51;276;522;246;
60;51;522;764;242;
60;51;764;1004;240;
60;51;1004;1241;237;
60;51;1241;1487;246;
60;51;1487;1731;244;
60;51;254;498;244;
60;52;498;750;252;247,1
60;52;750;998;248;
60;52;998;1247;249;
60;52;1247;1496;249;
60;52;1496;1739;243;
60;52;1739;1989;250;
60;52;283;527;244;
60;52;527;775;248;
60;52;775;1018;243;
60;52;1018;1263;245;
60;53;1263;1514;251;251,5
60;53;1514;1769;255;
60;53;313;563;250;
60;53;563;812;249;
60;53;812;1063;251;
60;53;1063;1316;253;
60;53;1316;1572;256;
60;53;1572;1824;252;
60;53;280;528;248;
60;53;528;778;250;
60;54;778;1035;257;256,9
60;54;1035;1291;256;
60;54;1291;1547;256;
60;54;1547;1808;261;
60;54;276;536;260;
60;54;536;793;257;
60;54;793;1047;254;
60;54;1047;1302;255;
60;54;1302;1555;253;
60;54;1555;1815;260;
60;55;245;507;262;263,9
60;55;507;773;266;
60;55;773;1038;265;
60;55;1038;1298;260;
60;55;1298;1561;263;
60;55;1561;1828;267;
60;55;256;522;266;
60;55;522;781;259;
60;55;781;1048;267;
60;55;1048;1312;264;
60;56;1312;1585;273;270,4
60;56;1585;1859;274;
60;56;319;584;265;
60;56;584;850;266;
60;56;850;1121;271;
60;56;1121;1394;273;
60;56;1394;1665;271;
60;56;1665;1937;272;
60;56;265;539;274;
60;56;539;804;265;
60;57;804;1080;276;275,5
60;57;1080;1355;275;
60;57;1355;1628;273;
60;57;1628;1904;276;
60;57;254;529;275;
60;57;529;807;278;
60;57;807;1085;278;
60;57;1085;1357;272;
60;57;1357;1632;275;
60;57;1632;1909;277;
60;58;276;558;282;279,4
60;58;558;837;279;
60;58;837;1117;280;
60;58;1117;1400;283;
60;58;1400;1679;279;
60;58;1679;1961;282;
60;58;301;580;279;
60;58;580;856;276;
60;58;856;1133;277;
60;58;1133;1410;277;
60;59;1410;1694;284;283,6
60;59;1694;1980;286;
60;59;256;539;283;
60;59;539;821;282;
60;59;821;1104;283;
60;59;1104;1387;283;
60;59;1387;1672;285;
60;59;1672;1955;283;
60;59;267;548;281;
60;59;548;834;286;
60;60;834;1120;286;288,3
60;60;1120;1407;287;
60;60;1407;1696;289;
60;60;287;576;289;
60;60;576;861;285;
60;60;861;1154;293;
60;60;1154;1440;286;
60;60;1440;1732;292;
60;60;256;541;285;
60;60;541;832;291;
70;1;1579;1585;6;3,6
70;1;1585;1586;1;
70;1;1586;1593;7;
70;1;1593;1595;2;
70;1;1595;1598;3;
70;1;1598;1600;2;
70;1;1600;1603;3;
70;1;1603;1609;6;
70;1;1609;1610;1;
70;1;1610;1615;5;
70;2;1615;1620;5;5,6
70;2;1620;1623;3;
70;2;1623;1630;7;
70;2;1630;1635;5;
70;2;1635;1640;5;
70;2;1640;1646;6;
70;2;1646;1656;10;
70;2;1656;1660;4;
70;2;1660;1665;5;
70;2;1665;1671;6;
70;3;1671;1683;12;8,4
70;3;1683;1690;7;
70;3;1690;1698;8;
70;3;1698;1704;6;
70;3;1704;1716;12;
70;3;1716;1724;8;
70;3;1724;1735;11;
70;3;1735;1738;3;
70;3;1738;1746;8;
70;3;1746;1755;9;
70;4;1755;1766;11;11,2
70;4;1766;1777;11;
70;4;1777;1790;13;
70;4;1790;1801;11;
70;4;1801;1812;11;
70;4;1812;1826;14;
70;4;1826;1834;8;
70;4;1834;1845;11;
70;4;1845;1856;11;
70;4;1856;1867;11;
70;5;1867;1880;13;14,2
70;5;1880;1894;14;
70;5;1894;1907;13;
70;5;1907;1922;15;
70;5;1922;1935;13;
70;5;1935;1948;13;
70;5;1948;1963;15;
70;5;1963;1977;14;
70;5;244;260;16;
70;5;260;276;16;
70;6;276;282;6;16
70;6;282;304;22;
70;6;304;320;16;
70;6;320;338;18;
70;6;338;355;17;
70;6;355;373;18;
70;6;373;388;15;
70;6;388;404;16;
70;6;404;420;16;
70;6;420;436;16;
70;7;436;456;20;19,5
70;7;456;476;20;
70;7;476;496;20;
70;7;496;515;19;
70;7;515;536;21;
70;7;536;554;18;
70;7;554;574;20;
70;7;574;593;19;
70;7;593;611;18;
70;7;611;631;20;
70;8;631;653;22;21,9
70;8;653;675;22;
70;8;675;698;23;
70;8;698;720;22;
70;8;720;743;23;
70;8;743;765;22;
70;8;765;786;21;
70;8;786;806;20;
70;8;806;828;22;
70;8;828;850;22;
70;9;850;874;24;24,7
70;9;874;900;26;
70;9;900;925;25;
70;9;925;948;23;
70;9;948;973;25;
70;9;973;997;24;
70;9;997;1022;25;
70;9;1022;1048;26;
70;9;1048;1073;25;
70;9;1073;1097;24;
70;10;1097;1123;26;27,1
70;10;1123;1151;28;
70;10;1151;1178;27;
70;10;1178;1205;27;
70;10;1205;1233;28;
70;10;1233;1262;29;
70;10;1262;1288;26;
70;10;1288;1315;27;
70;10;1315;1341;26;
70;10;1341;1368;27;
70;11;1368;1400;32;29,1
70;11;1400;1427;27;
70;11;1427;1456;29;
70;11;1456;1486;30;
70;11;1486;1515;29;
70;11;1515;1543;28;
70;11;1543;1571;28;
70;11;1571;1601;30;
70;11;1601;1630;29;
70;11;1630;1659;29;
70;12;1659;1689;30;31,9
70;12;1689;1730;41;
70;12;1730;1760;30;
70;12;1760;1792;32;
70;12;1792;1823;31;
70;12;1823;1853;30;
70;12;1853;1885;32;
70;12;1885;1916;31;
70;12;1916;1947;31;
70;12;1947;1978;31;
70;13;260;279;19;33,9
70;13;279;330;51;
70;13;330;363;33;
70;13;363;398;35;
70;13;398;432;34;
70;13;432;465;33;
70;13;465;497;32;
70;13;497;530;33;
70;13;530;564;34;
70;13;564;599;35;
70;14;599;638;39;37,4
70;14;638;676;38;
70;14;676;712;36;
70;14;712;749;37;
70;14;749;787;38;
70;14;787;826;39;
70;14;826;863;37;
70;14;863;899;36;
70;14;899;936;37;
70;14;936;973;37;
70;15;973;1018;45;39,4
70;15;1018;1051;33;
70;15;1051;1092;41;
70;15;1092;1132;40;
70;15;1132;1173;41;
70;15;1173;1212;39;
70;15;1212;1251;39;
70;15;1251;1289;38;
70;15;1289;1328;39;
70;15;1328;1367;39;
70;16;1367;1407;40;44,5
70;16;1407;1453;46;
70;16;1453;1501;48;
70;16;1501;1543;42;
70;16;1543;1586;43;
70;16;1586;1630;44;
70;16;1630;1677;47;
70;16;1677;1723;46;
70;16;1723;1768;45;
70;16;1768;1812;44;
70;17;1812;1864;52;49,3
70;17;1864;1911;47;
70;17;1911;1959;48;
70;17;254;303;49;
70;17;303;353;50;
70;17;353;404;51;
70;17;404;452;48;
70;17;452;501;49;
70;17;501;551;50;
70;17;551;600;49;
70;18;600;652;52;51,7
70;18;652;705;53;
70;18;705;753;48;
70;18;753;807;54;
70;18;807;862;55;
70;18;862;911;49;
70;18;911;961;50;
70;18;961;1012;51;
70;18;1012;1064;52;
70;18;1064;1117;53;
70;19;1117;1173;56;57,5
70;19;1173;1224;51;
70;19;1224;1279;55;
70;19;1279;1335;56;
70;19;1335;1392;57;
70;19;1392;1453;61;
70;19;1453;1515;62;
70;19;1515;1568;53;
70;19;1568;1627;59;
70;19;1627;1692;65;
70;20;1692;1752;60;60,5
70;20;1752;1809;57;
70;20;1809;1867;58;
70;20;1867;1931;64;
70;20;1931;1991;60;
70;20;278;339;61;
70;20;339;401;62;
70;20;401;461;60;
70;20;461;522;61;
70;20;522;584;62;
70;21;584;648;64;64,1
70;21;648;706;58;
70;21;706;766;60;
70;21;766;829;63;
70;21;829;893;64;
70;21;893;958;65;
70;21;958;1027;69;
70;21;1027;1094;67;
70;21;1094;1162;68;
70;21;1162;1225;63;
70;22;1225;1291;66;66,6
70;22;1291;1359;68;
70;22;1359;1423;64;
70;22;1423;1492;69;
70;22;1492;1562;70;
70;22;1562;1631;69;
70;22;1631;1699;68;
70;22;1699;1762;63;
70;22;1762;1826;64;
70;22;1826;1891;65;
70;23;1891;1955;64;69,6
70;23;268;329;61;
70;23;329;395;66;
70;23;395;464;69;
70;23;464;534;70;
70;23;534;606;72;
70;23;606;680;74;
70;23;680;751;71;
70;23;751;827;76;
70;23;827;900;73;
70;24;900;968;68;71,9
70;24;968;1032;64;
70;24;1032;1097;65;
70;24;1097;1166;69;
70;24;1166;1244;78;
70;24;1244;1317;73;
70;24;1317;1394;77;
70;24;1394;1473;79;
70;24;1473;1543;70;
70;24;1543;1619;76;
70;25;1619;1701;82;75,9
70;25;1701;1779;78;
70;25;1779;1858;79;
70;25;1858;1934;76;
70;25;300;377;77;
70;25;377;448;71;
70;25;448;520;72;
70;25;520;593;73;
70;25;593;670;77;
70;25;670;744;74;
70;26;744;824;80;80,3
70;26;824;907;83;
70;26;907;991;84;
70;26;991;1070;79;
70;26;1070;1150;80;
70;26;1150;1232;82;
70;26;1232;1309;77;
70;26;1309;1387;78;
70;26;1387;1466;79;
70;26;1466;1547;81;
70;27;1547;1629;82;82,3
70;27;1629;1712;83;
70;27;1712;1792;80;
70;27;1792;1878;86;
70;27;1878;1965;87;
70;27;289;372;83;
70;27;372;454;82;
70;27;454;535;81;
70;27;535;615;80;
70;27;615;694;79;
70;28;694;780;86;85
70;28;780;867;87;
70;28;867;955;88;
70;28;955;1040;85;
70;28;1040;1124;84;
70;28;1124;1205;81;
70;28;1205;1294;89;
70;28;1294;1378;84;
70;28;1378;1460;82;
70;28;1460;1544;84;
70;29;1544;1633;89;89,1
70;29;1633;1723;90;
70;29;1723;1814;91;
70;29;1814;1902;88;
70;29;1902;1991;89;
70;29;265;352;87;
70;29;352;438;86;
70;29;438;526;88;
70;29;526;617;91;
70;29;617;709;92;
70;30;709;799;90;92,2
70;30;799;889;90;
70;30;889;981;92;
70;30;981;1074;93;
70;30;1074;1165;91;
70;30;1165;1257;92;
70;30;1257;1351;94;
70;30;1351;1446;95;
70;30;1446;1538;92;
70;30;1538;1631;93;
70;31;1631;1723;92;95,7
70;31;1723;1821;98;
70;31;1821;1917;96;
70;31;276;370;94;
70;31;370;469;99;
70;31;469;566;97;
70;31;566;658;92;
70;31;658;758;100;
70;31;758;852;94;
70;31;852;947;95;
70;32;947;1050;103;100,2
70;32;1050;1153;103;
70;32;1153;1249;96;
70;32;1249;1352;103;
70;32;1352;1455;103;
70;32;1455;1556;101;
70;32;1556;1653;97;
70;32;1653;1754;101;
70;32;1754;1850;96;
70;32;1850;1949;99;
70;33;245;348;103;103,5
70;33;348;454;106;
70;33;454;559;105;
70;33;559;667;108;
70;33;667;766;99;
70;33;766;871;105;
70;33;871;971;100;
70;33;971;1072;101;
70;33;1072;1173;101;
70;33;1173;1280;107;
70;34;1280;1387;107;107,6
70;34;1387;1498;111;
70;34;1498;1610;112;
70;34;1610;1721;111;
70;34;1721;1826;105;
70;34;1826;1930;104;
70;34;267;377;110;
70;34;377;481;104;
70;34;481;585;104;
70;34;585;693;108;
70;35;693;807;114;112
70;35;807;922;115;
70;35;922;1030;108;
70;35;1030;1138;108;
70;35;1138;1251;113;
70;35;1251;1362;111;
70;35;1362;1476;114;
70;35;1476;1585;109;
70;35;1585;1701;116;
70;35;1701;1813;112;
70;36;1813;1932;119;113,8
70;36;287;398;111;
70;36;398;515;117;
70;36;515;631;116;
70;36;631;747;116;
70;36;747;858;111;
70;36;858;970;112;
70;36;970;1082;112;
70;36;1082;1194;112;
70;36;1194;1306;112;
70;37;1306;1428;122;118,1
70;37;1428;1550;122;
70;37;1550;1663;113;
70;37;1663;1776;113;
70;37;1776;1898;122;
70;37;264;383;119;
70;37;383;500;117;
70;37;500;620;120;
70;37;620;737;117;
70;37;737;853;116;
70;38;853;973;120;119,8
70;38;973;1096;123;
70;38;1096;1216;120;
70;38;1216;1334;118;
70;38;1334;1451;117;
70;38;1451;1574;123;
70;38;1574;1691;117;
70;38;1691;1808;117;
70;38;1808;1934;126;
70;38;298;415;117;
70;39;415;540;125;124,2
70;39;540;665;125;
70;39;665;791;126;
70;39;791;915;124;
70;39;915;1039;124;
70;39;1039;1164;125;
70;39;1164;1286;122;
70;39;1286;1408;122;
70;39;1408;1531;123;
70;39;1531;1657;126;
70;40;1657;1780;123;127,3
70;40;1780;1907;127;
70;40;256;387;131;
70;40;387;519;132;
70;40;519;642;123;
70;40;642;771;129;
70;40;771;899;128;
70;40;899;1024;125;
70;40;1024;1149;125;
70;40;1149;1279;130;
70;41;1279;1409;130;131
70;41;1409;1542;133;
70;41;1542;1673;131;
70;41;1673;1803;130;
70;41;1803;1937;134;
70;41;265;394;129;
70;41;394;521;127;
70;41;521;655;134;
70;41;655;782;127;
70;41;782;917;135;
70;42;917;1051;134;134,3
70;42;1051;1182;131;
70;42;1182;1321;139;
70;42;1321;1458;137;
70;42;1458;1588;130;
70;42;1588;1721;133;
70;42;1721;1854;133;
70;42;312;444;132;
70;42;444;580;136;
70;42;580;718;138;
70;43;718;856;138;138
70;43;856;995;139;
70;43;995;1136;141;
70;43;1136;1274;138;
70;43;1274;1416;142;
70;43;1416;1554;138;
70;43;1554;1691;137;
70;43;1691;1828;137;
70;43;298;435;137;
70;43;435;568;133;
70;44;568;706;138;141,7
70;44;706;851;145;
70;44;851;997;146;
70;44;997;1140;143;
70;44;1140;1279;139;
70;44;1279;1424;145;
70;44;1424;1567;143;
70;44;1567;1704;137;
70;44;1704;1841;137;
70;44;1841;1985;144;
70;45;256;400;144;144,6
70;45;286;431;145;
70;45;431;572;141;
70;45;572;714;142;
70;45;714;864;150;
70;45;864;1012;148;
70;45;1012;1154;142;
70;45;1154;1295;141;
70;45;1295;1440;145;
70;45;1440;1588;148;
70;46;1588;1734;146;149,5
70;46;1734;1883;149;
70;46;265;415;150;
70;46;415;566;151;
70;46;566;719;153;
70;46;719;870;151;
70;46;870;1017;147;
70;46;1017;1166;149;
70;46;1166;1316;150;
70;46;1316;1465;149;
70;47;1465;1623;158;153,4
70;47;1623;1779;156;
70;47;1779;1936;157;
70;47;278;431;153;
70;47;431;588;157;
70;47;588;738;150;
70;47;738;887;149;
70;47;887;1036;149;
70;47;1036;1186;150;
70;47;1186;1341;155;
70;48;1341;1498;157;156,8
70;48;1498;1658;160;
70;48;1658;1810;152;
70;48;245;403;158;
70;48;403;565;162;
70;48;565;724;159;
70;48;724;877;153;
70;48;877;1032;155;
70;48;1032;1184;152;
70;48;1184;1344;160;
70;49;1344;1506;162;159,7
70;49;1506;1664;158;
70;49;1664;1826;162;
70;49;278;436;158;
70;49;436;595;159;
70;49;595;751;156;
70;49;751;907;156;
70;49;907;1070;163;
70;49;1070;1233;163;
70;49;1233;1393;160;
70;50;1393;1555;162;162,4
70;50;1555;1718;163;
70;50;1718;1877;159;
70;50;267;428;161;
70;50;428;595;167;
70;50;595;755;160;
70;50;755;921;166;
70;50;921;1085;164;
70;50;1085;1248;163;
70;50;1248;1407;159;
70;51;1407;1576;169;166
70;51;1576;1746;170;
70;51;1746;1914;168;
70;51;289;450;161;
70;51;450;617;167;
70;51;617;785;168;
70;51;785;949;164;
70;51;949;1112;163;
70;51;1112;1276;164;
70;51;1276;1442;166;
70;52;1442;1615;173;169
70;52;1615;1783;168;
70;52;309;478;169;
70;52;478;651;173;
70;52;651;822;171;
70;52;822;988;166;
70;52;988;1153;165;
70;52;1153;1321;168;
70;52;1321;1488;167;
70;52;1488;1658;170;
70;53;1658;1828;170;171,2
70;53;298;467;169;
70;53;467;637;170;
70;53;637;810;173;
70;53;810;979;169;
70;53;979;1155;176;
70;53;1155;1331;176;
70;53;1331;1499;168;
70;53;1499;1671;172;
70;53;1671;1840;169;
70;54;276;450;174;173,6
70;54;450;626;176;
70;54;626;796;170;
70;54;796;972;176;
70;54;972;1151;179;
70;54;1151;1322;171;
70;54;1322;1497;175;
70;54;1497;1667;170;
70;54;1667;1841;174;
70;54;266;437;171;
70;55;437;610;173;175,9
70;55;610;787;177;
70;55;787;960;173;
70;55;960;1133;173;
70;55;1133;1310;177;
70;55;1310;1487;177;
70;55;1487;1666;179;
70;55;1666;1844;178;
70;55;276;455;179;
70;55;455;628;173;
70;56;628;806;178;180,4
70;56;806;982;176;
70;56;982;1163;181;
70;56;1163;1346;183;
70;56;1346;1521;175;
70;56;1521;1703;182;
70;56;1703;1887;184;
70;56;254;438;184;
70;56;438;621;183;
70;56;621;799;178;
70;57;799;980;181;184,4
70;57;980;1160;180;
70;57;1160;1348;188;
70;57;1348;1537;189;
70;57;1537;1717;180;
70;57;1717;1900;183;
70;57;278;465;187;
70;57;465;649;184;
70;57;649;838;189;
70;57;838;1021;183;
70;58;1021;1211;190;186,7
70;58;1211;1395;184;
70;58;1395;1581;186;
70;58;1581;1764;183;
70;58;287;471;184;
70;58;471;663;192;
70;58;663;846;183;
70;58;846;1039;193;
70;58;1039;1226;187;
70;58;1226;1411;185;
70;59;1411;1603;192;191,1
70;59;1603;1798;195;
70;59;276;470;194;
70;59;470;664;194;
70;59;664;850;186;
70;59;850;1043;193;
70;59;1043;1236;193;
70;59;1236;1424;188;
70;59;1424;1613;189;
70;59;1613;1800;187;
70;60;309;508;199;194,2
70;60;508;701;193;
70;60;701;891;190;
70;60;891;1086;195;
70;60;1086;1284;198;
70;60;1284;1475;191;
70;60;1475;1665;190;
70;60;1665;1858;193;
70;60;270;467;197;
70;60;467;663;196;
80;1;286;290;4;2,9
80;1;290;291;1;
80;1;291;294;3;
80;1;294;298;4;
80;1;298;301;3;
80;1;301;304;3;
80;1;304;306;2;
80;1;306;309;3;
80;1;309;312;3;
80;1;312;315;3;
80;2;315;322;7;5,8
80;2;322;328;6;
80;2;328;333;5;
80;2;333;339;6;
80;2;339;344;5;
80;2;344;350;6;
80;2;350;356;6;
80;2;356;362;6;
80;2;362;367;5;
80;2;367;373;6;
80;3;373;382;9;8,4
80;3;382;389;7;
80;3;389;399;10;
80;3;399;407;8;
80;3;424;433;9;
80;3;433;441;8;
80;3;441;449;8;
80;3;449;458;9;
80;3;458;467;9;
80;3;467;474;7;
80;4;474;486;12;11,6
80;4;486;497;11;
80;4;497;509;12;
80;4;509;519;10;
80;4;519;530;11;
80;4;530;542;12;
80;4;542;550;8;
80;4;550;564;14;
80;4;564;577;13;
80;4;577;590;13;
80;5;590;595;5;13,4
80;5;595;614;19;
80;5;614;628;14;
80;5;628;642;14;
80;5;642;656;14;
80;5;656;670;14;
80;5;670;683;13;
80;5;683;697;14;
80;5;697;710;13;
80;5;710;724;14;
80;6;724;741;17;16,9
80;6;741;759;18;
80;6;759;775;16;
80;6;775;791;16;
80;6;791;808;17;
80;6;808;826;18;
80;6;826;844;18;
80;6;844;861;17;
80;6;861;877;16;
80;6;877;893;16;
80;7;893;911;18;18,9
80;7;911;930;19;
80;7;930;949;19;
80;7;949;968;19;
80;7;968;988;20;
80;7;988;1007;19;
80;7;1007;1025;18;
80;7;1025;1044;19;
80;7;1044;1064;20;
80;7;1064;1082;18;
80;8;1082;1106;24;21,5
80;8;1106;1125;19;
80;8;1125;1148;23;
80;8;1148;1169;21;
80;8;1169;1191;22;
80;8;1191;1211;20;
80;8;1211;1233;22;
80;8;1233;1256;23;
80;8;1256;1276;20;
80;8;1276;1297;21;
80;9;1297;1320;23;23,9
80;9;1320;1345;25;
80;9;1345;1368;23;
80;9;1368;1392;24;
80;9;1392;1415;23;
80;9;1415;1440;25;
80;9;1440;1463;23;
80;9;1463;1487;24;
80;9;1487;1511;24;
80;9;1511;1536;25;
80;10;1536;1563;27;27,2
80;10;1563;1589;26;
80;10;1589;1616;27;
80;10;1616;1644;28;
80;10;1644;1673;29;
80;10;1673;1700;27;
80;10;1700;1728;28;
80;10;1728;1754;26;
80;10;1754;1781;27;
80;10;1781;1808;27;
80;11;1808;1835;27;29,4
80;11;1835;1867;32;
80;11;1867;1890;23;
80;11;1890;1920;30;
80;11;1920;1951;31;
80;11;1951;1980;29;
80;11;267;297;30;
80;11;297;325;28;
80;11;325;358;33;
80;11;358;389;31;
80;12;389;407;18;31,5
80;12;407;437;30;
80;12;437;469;32;
80;12;469;500;31;
80;12;500;532;32;
80;12;532;565;33;
80;12;565;600;35;
80;12;600;633;33;
80;12;633;667;34;
80;12;667;704;37;
80;13;704;739;35;35,6
80;13;739;773;34;
80;13;773;808;35;
80;13;808;844;36;
80;13;844;881;37;
80;13;881;917;36;
80;13;917;952;35;
80;13;952;987;35;
80;13;987;1023;36;
80;13;1023;1060;37;
80;14;1060;1098;38;37,6
80;14;1098;1134;36;
80;14;1134;1171;37;
80;14;1171;1207;36;
80;14;1207;1244;37;
80;14;1244;1282;38;
80;14;1282;1319;37;
80;14;1319;1359;40;
80;14;1359;1398;39;
80;14;1398;1436;38;
80;15;1436;1479;43;39,1
80;15;1479;1509;30;
80;15;1509;1543;34;
80;15;1543;1583;40;
80;15;1583;1624;41;
80;15;1624;1663;39;
80;15;1663;1703;40;
80;15;1703;1741;38;
80;15;1741;1785;44;
80;15;1785;1827;42;
80;16;1827;1863;36;42,4
80;16;1863;1904;41;
80;16;1904;1946;42;
80;16;1946;1989;43;
80;16;260;302;42;
80;16;302;344;42;
80;16;344;387;43;
80;16;387;431;44;
80;16;431;476;45;
80;16;476;522;46;
80;17;522;566;44;45
80;17;566;610;44;
80;17;610;653;43;
80;17;653;698;45;
80;17;698;744;46;
80;17;744;791;47;
80;17;791;836;45;
80;17;836;881;45;
80;17;881;926;45;
80;17;926;972;46;
80;18;972;1018;46;46,5
80;18;1018;1062;44;
80;18;1062;1108;46;
80;18;1108;1156;48;
80;18;1156;1203;47;
80;18;1203;1252;49;
80;18;1252;1299;47;
80;18;1299;1344;45;
80;18;1344;1390;46;
80;18;1390;1437;47;
80;19;1437;1486;49;48,6
80;19;1486;1533;47;
80;19;1533;1579;46;
80;19;1579;1628;49;
80;19;1628;1678;50;
80;19;1678;1729;51;
80;19;1729;1776;47;
80;19;1776;1824;48;
80;19;1824;1873;49;
80;19;1873;1923;50;
80;20;1923;1974;51;51,4
80;20;271;318;47;
80;20;318;367;49;
80;20;367;419;52;
80;20;419;472;53;
80;20;472;526;54;
80;20;526;581;55;
80;20;581;632;51;
80;20;632;682;50;
80;20;682;734;52;
80;21;734;786;52;53,4
80;21;786;835;49;
80;21;835;885;50;
80;21;885;939;54;
80;21;939;994;55;
80;21;994;1047;53;
80;21;1047;1101;54;
80;21;1101;1157;56;
80;21;1157;1211;54;
80;21;1211;1268;57;
80;22;1268;1321;53;55,5
80;22;1321;1373;52;
80;22;1373;1425;52;
80;22;1425;1482;57;
80;22;1482;1540;58;
80;22;1540;1599;59;
80;22;1599;1655;56;
80;22;1655;1710;55;
80;22;1710;1766;56;
80;22;1766;1823;57;
80;23;1823;1880;57;57,6
80;23;1880;1936;56;
80;23;1936;1993;57;
80;23;240;298;58;
80;23;298;355;57;
80;23;355;413;58;
80;23;413;471;58;
80;23;471;530;59;
80;23;530;588;58;
80;23;588;646;58;
80;24;646;705;59;60
80;24;705;766;61;
80;24;766;826;60;
80;24;826;886;60;
80;24;886;948;62;
80;24;948;1009;61;
80;24;1009;1068;59;
80;24;1068;1128;60;
80;24;1128;1187;59;
80;24;1187;1246;59;
80;25;1246;1308;62;63,2
80;25;1308;1369;61;
80;25;1369;1433;64;
80;25;1433;1496;63;
80;25;1496;1559;63;
80;25;1559;1623;64;
80;25;1623;1688;65;
80;25;1688;1753;65;
80;25;1753;1816;63;
80;25;1816;1878;62;
80;26;1878;1944;66;66,9
80;26;250;317;67;
80;26;317;385;68;
80;26;385;451;66;
80;26;451;518;67;
80;26;518;585;67;
80;26;585;653;68;
80;26;653;720;67;
80;26;720;788;68;
80;26;788;853;65;
80;27;853;922;69;69,8
80;27;922;992;70;
80;27;992;1063;71;
80;27;1063;1135;72;
80;27;1135;1204;69;
80;27;1204;1272;68;
80;27;1272;1341;69;
80;27;1341;1410;69;
80;27;1410;1480;70;
80;27;1480;1551;71;
80;28;1551;1623;72;72,6
80;28;1623;1696;73;
80;28;1696;1768;72;
80;28;1768;1840;72;
80;28;1840;1913;73;
80;28;1913;1985;72;
80;28;275;350;75;
80;28;350;426;76;
80;28;426;496;70;
80;28;496;567;71;
80;29;567;642;75;76,3
80;29;642;718;76;
80;29;718;795;77;
80;29;795;870;75;
80;29;870;946;76;
80;29;946;1022;76;
80;29;1022;1099;77;
80;29;1099;1174;75;
80;29;1174;1252;78;
80;29;1252;1330;78;
80;30;1330;1410;80;80,1
80;30;1410;1489;79;
80;30;1489;1569;80;
80;30;1569;1650;81;
80;30;1650;1732;82;
80;30;1732;1815;83;
80;30;1815;1892;77;
80;30;1892;1970;78;
80;30;276;356;80;
80;30;356;437;81;
80;31;437;517;80;83,1
80;31;517;599;82;
80;31;599;677;78;
80;31;677;762;85;
80;31;762;849;87;
80;31;849;933;84;
80;31;933;1018;85;
80;31;1018;1096;78;
80;31;1096;1184;88;
80;31;1184;1268;84;
80;32;1268;1349;81;85
80;32;1349;1435;86;
80;32;1435;1522;87;
80;32;1522;1603;81;
80;32;1603;1690;87;
80;32;1690;1771;81;
80;32;1771;1859;88;
80;32;1859;1946;87;
80;32;298;379;81;
80;32;379;470;91;
80;33;470;558;88;86,9
80;33;558;650;92;
80;33;650;733;83;
80;33;733;816;83;
80;33;816;907;91;
80;33;907;991;84;
80;33;991;1076;85;
80;33;1076;1159;83;
80;33;1159;1247;88;
80;33;1247;1339;92;
80;34;1339;1424;85;89,3
80;34;1424;1510;86;
80;34;1510;1598;88;
80;34;1598;1686;88;
80;34;1686;1776;90;
80;34;1776;1865;89;
80;34;256;349;93;
80;34;349;440;91;
80;34;440;532;92;
80;34;532;623;91;
80;35;623;714;91;91,3
80;35;714;803;89;
80;35;803;892;89;
80;35;892;986;94;
80;35;986;1074;88;
80;35;1074;1169;95;
80;35;1169;1260;91;
80;35;1260;1349;89;
80;35;1349;1440;91;
80;35;1440;1536;96;
80;36;1536;1628;92;94,5
80;36;1628;1722;94;
80;36;1722;1815;93;
80;36;276;373;97;
80;36;287;383;96;
80;36;383;479;96;
80;36;479;576;97;
80;36;576;670;94;
80;36;670;760;90;
80;36;760;856;96;
80;37;856;955;99;98,4
80;37;955;1049;94;
80;37;1049;1147;98;
80;37;1147;1249;102;
80;37;1249;1344;95;
80;37;1344;1445;101;
80;37;1445;1547;102;
80;37;1547;1642;95;
80;37;1642;1738;96;
80;37;1738;1840;102;
80;38;276;380;104;100,9
80;38;380;478;98;
80;38;478;578;100;
80;38;578;675;97;
80;38;675;776;101;
80;38;776;882;106;
80;38;882;985;103;
80;38;985;1087;102;
80;38;1087;1185;98;
80;38;1185;1285;100;
80;39;1285;1392;107;103
80;39;1392;1493;101;
80;39;1493;1595;102;
80;39;1595;1702;107;
80;39;1702;1808;106;
80;39;309;408;99;
80;39;408;507;99;
80;39;507;612;105;
80;39;612;711;99;
80;39;711;816;105;
80;40;816;923;107;106,8
80;40;923;1032;109;
80;40;1032;1142;110;
80;40;1142;1246;104;
80;40;1246;1356;110;
80;40;1356;1459;103;
80;40;1459;1567;108;
80;40;1567;1672;105;
80;40;1672;1778;106;
80;40;1778;1884;106;
80;41;265;375;110;110,3
80;41;375;487;112;
80;41;487;595;108;
80;41;595;702;107;
80;41;702;811;109;
80;41;811;922;111;
80;41;922;1034;112;
80;41;1034;1147;113;
80;41;1147;1254;107;
80;41;1254;1368;114;
80;42;1368;1486;118;113,4
80;42;1486;1597;111;
80;42;1597;1708;111;
80;42;1708;1825;117;
80;42;268;381;113;
80;42;381;497;116;
80;42;497;608;111;
80;42;608;721;113;
80;42;721;830;109;
80;42;830;945;115;
80;43;945;1064;119;114,6
80;43;1064;1176;112;
80;43;1176;1289;113;
80;43;1289;1403;114;
80;43;1403;1518;115;
80;43;1518;1631;113;
80;43;1631;1745;114;
80;43;1745;1861;116;
80;43;313;429;116;
80;43;429;543;114;
80;44;543;657;114;117,2
80;44;657;777;120;
80;44;777;890;113;
80;44;890;1007;117;
80;44;1007;1123;116;
80;44;1123;1242;119;
80;44;1242;1362;120;
80;44;1362;1481;119;
80;44;1481;1598;117;
80;44;1598;1715;117;
80;45;1715;1840;125;121
80;45;289;413;124;
80;45;413;531;118;
80;45;531;647;116;
80;45;647;765;118;
80;45;765;886;121;
80;45;886;1006;120;
80;45;1006;1127;121;
80;45;1127;1250;123;
80;45;1250;1374;124;
80;46;1374;1495;121;121,1
80;46;1495;1614;119;
80;46;1614;1735;121;
80;46;1735;1855;120;
80;46;276;396;120;
80;46;396;519;123;
80;46;519;640;121;
80;46;640;765;125;
80;46;765;885;120;
80;46;885;1006;121;
80;47;1006;1133;127;124
80;47;1133;1257;124;
80;47;1257;1379;122;
80;47;1379;1507;128;
80;47;1507;1636;129;
80;47;1636;1756;120;
80;47;1756;1878;122;
80;47;276;397;121;
80;47;397;525;128;
80;47;525;644;119;
80;48;644;774;130;126
80;48;774;901;127;
80;48;901;1030;129;
80;48;1030;1156;126;
80;48;1156;1278;122;
80;48;1278;1402;124;
80;48;1402;1530;128;
80;48;1530;1655;125;
80;48;1655;1782;127;
80;48;1782;1904;122;
80;49;276;404;128;128,5
80;49;404;528;124;
80;49;528;656;128;
80;49;656;789;133;
80;49;789;917;128;
80;49;917;1048;131;
80;49;1048;1179;131;
80;49;1179;1305;126;
80;49;1305;1435;130;
80;49;1435;1561;126;
80;50;1561;1688;127;131,3
80;50;1688;1822;134;
80;50;312;448;136;
80;50;448;582;134;
80;50;582;715;133;
80;50;715;847;132;
80;50;847;975;128;
80;50;975;1110;135;
80;50;1110;1237;127;
80;50;1237;1364;127;
80;51;1364;1498;134;134
80;51;1498;1634;136;
80;51;1634;1770;136;
80;51;1770;1900;130;
80;51;287;425;138;
80;51;425;563;138;
80;51;563;699;136;
80;51;699;829;130;
80;51;829;960;131;
80;51;960;1091;131;
80;52;1091;1230;139;138,2
80;52;1230;1370;140;
80;52;1370;1502;132;
80;52;1502;1643;141;
80;52;1643;1783;140;
80;52;245;381;136;
80;52;381;520;139;
80;52;520;655;135;
80;52;655;796;141;
80;52;796;935;139;
80;53;935;1075;140;142,3
80;53;1075;1220;145;
80;53;1220;1365;145;
80;53;1365;1505;140;
80;53;1505;1647;142;
80;53;1647;1792;145;
80;53;276;417;141;
80;53;417;557;140;
80;53;557;696;139;
80;53;696;842;146;
80;54;842;991;149;147,1
80;54;991;1137;146;
80;54;1137;1283;146;
80;54;1283;1426;143;
80;54;1426;1576;150;
80;54;1576;1726;150;
80;54;1726;1870;144;
80;54;290;440;150;
80;54;440;583;143;
80;54;583;733;150;
80;55;733;878;145;149,4
80;55;878;1023;145;
80;55;1023;1169;146;
80;55;1169;1316;147;
80;55;1316;1467;151;
80;55;1467;1620;153;
80;55;1620;1775;155;
80;55;1775;1929;154;
80;55;270;422;152;
80;55;422;568;146;
80;56;568;724;156;152,3
80;56;724;879;155;
80;56;879;1030;151;
80;56;1030;1185;155;
80;56;1185;1338;153;
80;56;1338;1487;149;
80;56;1487;1636;149;
80;56;1636;1791;155;
80;56;1791;1941;150;
80;56;254;404;150;
80;57;404;555;151;155,7
80;57;555;715;160;
80;57;715;872;157;
80;57;872;1029;157;
80;57;1029;1187;158;
80;57;1187;1346;159;
80;57;1346;1499;153;
80;57;1499;1650;151;
80;57;1650;1807;157;
80;57;296;450;154;
80;58;450;605;155;158,1
80;58;605;764;159;
80;58;764;919;155;
80;58;919;1079;160;
80;58;1079;1236;157;
80;58;1236;1392;156;
80;58;1392;1552;160;
80;58;1552;1707;155;
80;58;1707;1868;161;
80;58;275;438;163;
80;59;438;594;156;159,2
80;59;594;755;161;
80;59;755;920;165;
80;59;920;1084;164;
80;59;1084;1245;161;
80;59;1245;1401;156;
80;59;1401;1557;156;
80;59;1557;1717;160;
80;59;1717;1874;157;
80;59;267;423;156;
80;60;423;582;159;161,3
80;60;582;742;160;
80;60;742;904;162;
80;60;904;1063;159;
80;60;1063;1224;161;
80;60;1224;1390;166;
80;60;1390;1555;165;
80;60;1555;1717;162;
80;60;265;426;161;
80;60;426;584;158;
90;1;247;248;1;2,3
90;1;248;249;1;
90;1;249;251;2;
90;1;251;253;2;
90;1;253;256;3;
90;1;256;258;2;
90;1;258;260;2;
90;1;260;264;4;
90;1;264;267;3;
90;1;267;270;3;
90;2;270;275;5;5,2
90;2;275;282;7;
90;2;282;286;4;
90;2;286;292;6;
90;2;292;298;6;
90;2;298;304;6;
90;2;304;308;4;
90;2;308;314;6;
90;2;314;319;5;
90;2;319;322;3;
90;3;322;334;12;7,8
90;3;334;339;5;
90;3;339;347;8;
90;3;347;355;8;
90;3;355;364;9;
90;3;364;370;6;
90;3;370;378;8;
90;3;378;386;8;
90;3;386;393;7;
90;3;393;400;7;
90;4;400;409;9;10
90;4;409;422;13;
90;4;422;428;6;
90;4;428;440;12;
90;4;440;451;11;
90;4;451;460;9;
90;4;460;469;9;
90;4;469;478;9;
90;4;478;489;11;
90;4;489;500;11;
90;5;500;513;13;12,2
90;5;513;525;12;
90;5;525;538;13;
90;5;538;549;11;
90;5;549;561;12;
90;5;561;574;13;
90;5;574;586;12;
90;5;586;599;13;
90;5;599;610;11;
90;5;610;622;12;
90;6;622;638;16;15,2
90;6;638;654;16;
90;6;654;666;12;
90;6;666;683;17;
90;6;683;695;12;
90;6;695;709;14;
90;6;709;725;16;
90;6;725;742;17;
90;6;742;758;16;
90;6;758;774;16;
90;7;774;793;19;17,4
90;7;793;811;18;
90;7;811;828;17;
90;7;828;846;18;
90;7;846;862;16;
90;7;862;880;18;
90;7;880;897;17;
90;7;897;913;16;
90;7;913;931;18;
90;7;931;948;17;
90;8;948;971;23;20,4
90;8;971;989;18;
90;8;989;1009;20;
90;8;1009;1028;19;
90;8;1028;1049;21;
90;8;1049;1068;19;
90;8;1068;1088;20;
90;8;1088;1109;21;
90;8;1109;1131;22;
90;8;1131;1152;21;
90;9;1152;1171;19;20,9
90;9;1171;1194;23;
90;9;1194;1216;22;
90;9;1216;1233;17;
90;9;1233;1256;23;
90;9;1256;1274;18;
90;9;1274;1293;19;
90;9;1293;1315;22;
90;9;1315;1338;23;
90;9;1338;1361;23;
90;10;1361;1393;32;24,7
90;10;1393;1412;19;
90;10;1412;1436;24;
90;10;1436;1457;21;
90;10;1457;1482;25;
90;10;1482;1508;26;
90;10;1508;1532;24;
90;10;1532;1557;25;
90;10;1557;1582;25;
90;10;1582;1608;26;
90;11;1608;1635;27;25
90;11;1635;1660;25;
90;11;1660;1686;26;
90;11;1686;1712;26;
90;11;1712;1732;20;
90;11;1732;1757;25;
90;11;1757;1783;26;
90;11;1783;1807;24;
90;11;1807;1831;24;
90;11;1831;1858;27;
90;12;1858;1894;36;28,4
90;12;1894;1920;26;
90;12;1920;1947;27;
90;12;1947;1978;31;
90;12;250;273;23;
90;12;273;299;26;
90;12;299;327;28;
90;12;327;357;30;
90;12;357;384;27;
90;12;384;414;30;
90;13;414;444;30;31,5
90;13;444;476;32;
90;13;476;504;28;
90;13;504;535;31;
90;13;535;569;34;
90;13;569;599;30;
90;13;599;631;32;
90;13;631;665;34;
90;13;665;695;30;
90;13;695;729;34;
90;14;729;758;29;31,3
90;14;758;791;33;
90;14;791;821;30;
90;14;821;852;31;
90;14;852;883;31;
90;14;883;916;33;
90;14;916;949;33;
90;14;949;980;31;
90;14;980;1012;32;
90;14;1012;1042;30;
90;15;1042;1069;27;34,1
90;15;1069;1102;33;
90;15;1102;1147;45;
90;15;1147;1170;23;
90;15;1170;1210;40;
90;15;1210;1243;33;
90;15;1243;1286;43;
90;15;1286;1326;40;
90;15;1326;1353;27;
90;15;1353;1383;30;
90;16;1383;1416;33;36,7
90;16;1416;1454;38;
90;16;1454;1492;38;
90;16;1492;1529;37;
90;16;1529;1567;38;
90;16;1567;1606;39;
90;16;1606;1642;36;
90;16;1642;1679;37;
90;16;1679;1715;36;
90;16;1715;1750;35;
90;17;1750;1790;40;39,8
90;17;1790;1830;40;
90;17;1830;1870;40;
90;17;1870;1908;38;
90;17;1908;1947;39;
90;17;1947;1987;40;
90;17;271;311;40;
90;17;311;352;41;
90;17;352;392;40;
90;17;392;432;40;
90;18;432;475;43;42,1
90;18;475;517;42;
90;18;517;558;41;
90;18;558;601;43;
90;18;601;643;42;
90;18;643;684;41;
90;18;684;725;41;
90;18;725;767;42;
90;18;767;810;43;
90;18;810;853;43;
90;19;853;896;43;44,1
90;19;896;940;44;
90;19;940;983;43;
90;19;983;1027;44;
90;19;1027;1072;45;
90;19;1072;1117;45;
90;19;1117;1163;46;
90;19;1163;1207;44;
90;19;1207;1250;43;
90;19;1250;1294;44;
90;20;1294;1340;46;46,3
90;20;1340;1386;46;
90;20;1386;1433;47;
90;20;1433;1479;46;
90;20;1479;1524;45;
90;20;1524;1571;47;
90;20;1571;1617;46;
90;20;1617;1664;47;
90;20;1664;1710;46;
90;20;1710;1757;47;
90;21;1757;1806;49;47,8
90;21;1806;1851;45;
90;21;1851;1897;46;
90;21;1897;1944;47;
90;21;1944;1992;48;
90;21;268;316;48;
90;21;316;364;48;
90;21;364;413;49;
90;21;413;462;49;
90;21;462;511;49;
90;22;511;560;49;50
90;22;560;611;51;
90;22;611;660;49;
90;22;660;710;50;
90;22;710;761;51;
90;22;761;811;50;
90;22;811;861;50;
90;22;861;910;49;
90;22;910;960;50;
90;22;960;1011;51;
90;23;1011;1060;49;52
90;23;1060;1110;50;
90;23;1110;1161;51;
90;23;1161;1213;52;
90;23;1213;1264;51;
90;23;1264;1317;53;
90;23;1317;1372;55;
90;23;1372;1424;52;
90;23;1424;1477;53;
90;23;1477;1531;54;
90;24;1531;1585;54;54,3
90;24;1585;1635;50;
90;24;1635;1690;55;
90;24;1690;1744;54;
90;24;1744;1799;55;
90;24;1799;1855;56;
90;24;1855;1909;54;
90;24;1909;1964;55;
90;24;271;327;56;
90;24;327;381;54;
90;25;381;434;53;56,3
90;25;434;488;54;
90;25;488;541;53;
90;25;541;597;56;
90;25;597;654;57;
90;25;654;712;58;
90;25;712;769;57;
90;25;769;827;58;
90;25;827;886;59;
90;25;886;944;58;
90;26;944;1003;59;58,9
90;26;1003;1062;59;
90;26;1062;1122;60;
90;26;1122;1179;57;
90;26;1179;1237;58;
90;26;1237;1296;59;
90;26;1296;1356;60;
90;26;1356;1414;58;
90;26;1414;1473;59;
90;26;1473;1533;60;
90;27;1533;1593;60;61
90;27;1593;1654;61;
90;27;1654;1715;61;
90;27;1715;1775;60;
90;27;1775;1837;62;
90;27;1837;1896;59;
90;27;1896;1957;61;
90;27;287;349;62;
90;27;349;410;61;
90;27;410;473;63;
90;28;473;537;64;63,3
90;28;537;600;63;
90;28;600;665;65;
90;28;665;728;63;
90;28;728;792;64;
90;28;792;855;63;
90;28;855;919;64;
90;28;919;981;62;
90;28;981;1044;63;
90;28;1044;1106;62;
90;29;1106;1172;66;66
90;29;1172;1239;67;
90;29;1239;1307;68;
90;29;1307;1372;65;
90;29;1372;1439;67;
90;29;1439;1505;66;
90;29;1505;1570;65;
90;29;1570;1635;65;
90;29;1635;1701;66;
90;29;1701;1766;65;
90;30;1766;1833;67;68,4
90;30;1833;1901;68;
90;30;1901;1970;69;
90;30;263;331;68;
90;30;331;399;68;
90;30;399;468;69;
90;30;468;535;67;
90;30;535;605;70;
90;30;605;674;69;
90;30;674;743;69;
90;31;743;814;71;69,2
90;31;814;884;70;
90;31;884;952;68;
90;31;952;1024;72;
90;31;1024;1092;68;
90;31;1092;1158;66;
90;31;1158;1230;72;
90;31;1230;1297;67;
90;31;1297;1369;72;
90;31;1369;1435;66;
90;32;1435;1507;72;71,2
90;32;1507;1574;67;
90;32;1574;1643;69;
90;32;1643;1713;70;
90;32;1713;1786;73;
90;32;1786;1855;69;
90;32;1855;1928;73;
90;32;265;336;71;
90;32;336;410;74;
90;32;410;484;74;
90;33;484;551;67;69,1
90;33;551;617;66;
90;33;617;687;70;
90;33;687;762;75;
90;33;762;835;73;
90;33;835;901;66;
90;33;901;971;70;
90;33;971;1037;66;
90;33;1037;1108;71;
90;33;1108;1175;67;
90;34;1175;1248;73;71,4
90;34;1248;1321;73;
90;34;1321;1388;67;
90;34;1388;1460;72;
90;34;1460;1533;73;
90;34;1533;1604;71;
90;34;1604;1679;75;
90;34;1679;1747;68;
90;34;1747;1816;69;
90;34;1816;1889;73;
90;35;256;329;73;74,6
90;35;276;345;69;
90;35;345;422;77;
90;35;422;496;74;
90;35;496;571;75;
90;35;571;647;76;
90;35;647;725;78;
90;35;725;801;76;
90;35;801;871;70;
90;35;871;949;78;
90;36;949;1030;81;77,9
90;36;1030;1108;78;
90;36;1108;1182;74;
90;36;1182;1261;79;
90;36;1261;1340;79;
90;36;1340;1420;80;
90;36;1420;1494;74;
90;36;1494;1568;74;
90;36;1568;1649;81;
90;36;1649;1728;79;
90;37;1728;1813;85;79,8
90;37;1813;1890;77;
90;37;256;334;78;
90;37;334;412;78;
90;37;412;491;79;
90;37;491;573;82;
90;37;573;653;80;
90;37;653;732;79;
90;37;732;810;78;
90;37;810;892;82;
90;38;892;974;82;81,8
90;38;974;1053;79;
90;38;1053;1131;78;
90;38;1131;1216;85;
90;38;1216;1303;87;
90;38;1303;1383;80;
90;38;1383;1466;83;
90;38;1466;1549;83;
90;38;1549;1628;79;
90;38;1628;1710;82;
90;39;1710;1790;80;83,2
90;39;1790;1877;87;
90;39;1877;1963;86;
90;39;260;340;80;
90;39;340;425;85;
90;39;425;512;87;
90;39;512;593;81;
90;39;593;674;81;
90;39;674;755;81;
90;39;755;839;84;
90;40;839;926;87;85,4
90;40;926;1015;89;
90;40;1015;1101;86;
90;40;1101;1185;84;
90;40;1185;1271;86;
90;40;1271;1354;83;
90;40;1354;1441;87;
90;40;1441;1526;85;
90;40;1526;1611;85;
90;40;1611;1693;82;
90;41;1693;1776;83;88
90;41;1776;1867;91;
90;41;256;344;88;
90;41;344;436;92;
90;41;436;520;84;
90;41;520;611;91;
90;41;611;702;91;
90;41;702;788;86;
90;41;788;872;84;
90;41;872;962;90;
90;42;962;1051;89;89,4
90;42;1051;1139;88;
90;42;1139;1225;86;
90;42;1225;1314;89;
90;42;1314;1407;93;
90;42;1407;1493;86;
90;42;1493;1579;86;
90;42;1579;1672;93;
90;42;1672;1762;90;
90;42;1762;1856;94;
90;43;1856;1951;95;91,5
90;43;301;389;88;
90;43;256;348;92;
90;43;348;440;92;
90;43;440;533;93;
90;43;533;623;90;
90;43;623;717;94;
90;43;717;809;92;
90;43;809;898;89;
90;43;898;988;90;
90;44;988;1079;91;93,4
90;44;1079;1173;94;
90;44;1173;1269;96;
90;44;1269;1360;91;
90;44;1360;1450;90;
90;44;1450;1545;95;
90;44;1545;1637;92;
90;44;1637;1730;93;
90;44;1730;1826;96;
90;44;277;373;96;
90;45;373;466;93;95,6
90;45;466;559;93;
90;45;559;653;94;
90;45;653;746;93;
90;45;746;840;94;
90;45;840;940;100;
90;45;940;1036;96;
90;45;1036;1135;99;
90;45;1135;1233;98;
90;45;1233;1329;96;
90;46;1329;1431;102;96,7
90;46;1431;1529;98;
90;46;1529;1626;97;
90;46;1626;1722;96;
90;46;1722;1817;95;
90;46;1817;1910;93;
90;46;265;360;95;
90;46;360;453;93;
90;46;453;549;96;
90;46;549;651;102;
90;47;651;752;101;99,7
90;47;752;853;101;
90;47;853;952;99;
90;47;952;1055;103;
90;47;1055;1157;102;
90;47;1157;1253;96;
90;47;1253;1356;103;
90;47;1356;1450;94;
90;47;1450;1547;97;
90;47;1547;1648;101;
90;48;1648;1746;98;101,2
90;48;1746;1851;105;
90;48;276;374;98;
90;48;298;397;99;
90;48;397;496;99;
90;48;496;601;105;
90;48;601;701;100;
90;48;701;801;100;
90;48;801;903;102;
90;48;903;1009;106;
90;49;1009;1112;103;103
90;49;1112;1213;101;
90;49;1213;1318;105;
90;49;1318;1420;102;
90;49;1420;1525;105;
90;49;1525;1631;106;
90;49;1631;1730;99;
90;49;1730;1838;108;
90;49;1838;1939;101;
90;49;278;378;100;
90;50;378;487;109;106
90;50;487;591;104;
90;50;591;700;109;
90;50;700;808;108;
90;50;808;914;106;
90;50;914;1023;109;
90;50;1023;1124;101;
90;50;1124;1227;103;
90;50;1227;1334;107;
90;50;1334;1438;104;
90;51;1438;1547;109;108,2
90;51;1547;1653;106;
90;51;1653;1765;112;
90;51;1765;1873;108;
90;51;281;390;109;
90;51;390;499;109;
90;51;499;608;109;
90;51;608;715;107;
90;51;715;819;104;
90;51;819;928;109;
90;52;928;1035;107;109,3
90;52;1035;1148;113;
90;52;1148;1255;107;
90;52;1255;1364;109;
90;52;1364;1477;113;
90;52;1477;1588;111;
90;52;1588;1696;108;
90;52;1696;1803;107;
90;52;256;362;106;
90;52;362;474;112;
90;53;276;388;112;110,9
90;53;388;499;111;
90;53;499;611;112;
90;53;611;721;110;
90;53;721;829;108;
90;53;829;938;109;
90;53;938;1048;110;
90;53;1048;1160;112;
90;53;1160;1270;110;
90;53;1270;1385;115;
90;54;1385;1496;111;113,3
90;54;1496;1610;114;
90;54;1610;1727;117;
90;54;1727;1839;112;
90;54;289;400;111;
90;54;400;516;116;
90;54;516;630;114;
90;54;630;739;109;
90;54;739;856;117;
90;54;856;968;112;
90;55;968;1082;114;114,9
90;55;1082;1196;114;
90;55;1196;1316;120;
90;55;1316;1429;113;
90;55;1429;1546;117;
90;55;1546;1666;120;
90;55;1666;1777;111;
90;55;1777;1888;111;
90;55;255;366;111;
90;55;366;484;118;
90;56;484;599;115;116,5
90;56;599;720;121;
90;56;720;833;113;
90;56;833;948;115;
90;56;948;1065;117;
90;56;1065;1184;119;
90;56;1184;1300;116;
90;56;1300;1418;118;
90;56;1418;1533;115;
90;56;1533;1649;116;
90;57;1649;1766;117;117,7
90;57;300;421;121;
90;57;421;540;119;
90;57;267;381;114;
90;57;381;504;123;
90;57;504;622;118;
90;57;622;738;116;
90;57;738;854;116;
90;57;854;971;117;
90;57;971;1087;116;
90;58;1087;1208;121;120,4
90;58;1208;1332;124;
90;58;1332;1453;121;
90;58;1453;1572;119;
90;58;1572;1696;124;
90;58;1696;1812;116;
90;58;272;393;121;
90;58;393;514;121;
90;58;514;635;121;
90;58;635;751;116;
90;59;751;870;119;122
90;59;870;994;124;
90;59;994;1115;121;
90;59;1115;1238;123;
90;59;1238;1360;122;
90;59;1360;1478;118;
90;59;1478;1599;121;
90;59;1599;1717;118;
90;59;1717;1844;127;
90;59;280;407;127;
90;60;276;403;127;126
90;60;280;406;126;
90;60;406;532;126;
90;60;532;659;127;
90;60;659;788;129;
90;60;788;916;128;
90;60;916;1040;124;
90;60;1040;1160;120;
90;60;1160;1287;127;
90;60;1287;1413;126;
100;1;250;251;1;2,3
100;1;251;253;2;
100;1;253;256;3;
100;1;256;258;2;
100;1;258;261;3;
100;1;261;263;2;
100;1;263;265;2;
100;1;265;268;3;
100;1;268;270;2;
100;1;270;273;3;
100;2;273;277;4;4,6
100;2;277;285;8;
100;2;285;289;4;
100;2;289;292;3;
100;2;292;296;4;
100;2;296;301;5;
100;2;301;306;5;
100;2;306;310;4;
100;2;310;315;5;
100;2;315;319;4;
100;3;319;327;8;6,2
100;3;327;330;3;
100;3;330;336;6;
100;3;336;342;6;
100;3;342;349;7;
100;3;349;355;6;
100;3;355;360;5;
100;3;360;366;6;
100;3;366;373;7;
100;3;373;381;8;
100;4;381;392;11;9,3
100;4;392;402;10;
100;4;402;411;9;
100;4;411;419;8;
100;4;419;428;9;
100;4;428;436;8;
100;4;436;447;11;
100;4;447;457;10;
100;4;457;465;8;
100;4;465;474;9;
100;5;474;485;11;11,5
100;5;485;498;13;
100;5;498;510;12;
100;5;510;522;12;
100;5;522;532;10;
100;5;532;543;11;
100;5;543;556;13;
100;5;556;570;14;
100;5;570;580;10;
100;5;580;589;9;
100;6;589;602;13;13,5
100;6;602;616;14;
100;6;616;630;14;
100;6;630;643;13;
100;6;643;658;15;
100;6;658;672;14;
100;6;672;684;12;
100;6;684;698;14;
100;6;698;711;13;
100;6;711;724;13;
100;7;724;740;16;15,7
100;7;740;757;17;
100;7;757;772;15;
100;7;772;787;15;
100;7;787;802;15;
100;7;802;818;16;
100;7;818;834;16;
100;7;834;849;15;
100;7;849;865;16;
100;7;865;881;16;
100;8;881;902;21;18
100;8;902;920;18;
100;8;920;934;14;
100;8;934;951;17;
100;8;951;970;19;
100;8;970;986;16;
100;8;986;1006;20;
100;8;1006;1027;21;
100;8;1027;1044;17;
100;8;1044;1061;17;
100;9;1061;1083;22;20,7
100;9;1083;1103;20;
100;9;1103;1123;20;
100;9;1123;1144;21;
100;9;1144;1166;22;
100;9;1166;1186;20;
100;9;1186;1206;20;
100;9;1206;1225;19;
100;9;1225;1246;21;
100;9;1246;1268;22;
100;10;1268;1290;22;22,3
100;10;1290;1312;22;
100;10;1312;1334;22;
100;10;1334;1355;21;
100;10;1355;1378;23;
100;10;1378;1400;22;
100;10;1400;1424;24;
100;10;1424;1446;22;
100;10;1446;1469;23;
100;10;1469;1491;22;
100;11;1491;1515;24;24,5
100;11;1515;1538;23;
100;11;1538;1558;20;
100;11;1558;1584;26;
100;11;1584;1609;25;
100;11;1609;1637;28;
100;11;1637;1662;25;
100;11;1662;1686;24;
100;11;1686;1708;22;
100;11;1708;1736;28;
100;12;1736;1765;29;26,6
100;12;1765;1786;21;
100;12;1786;1810;24;
100;12;1810;1838;28;
100;12;1838;1865;27;
100;12;1865;1891;26;
100;12;1891;1917;26;
100;12;1917;1946;29;
100;12;1946;1974;28;
100;12;259;287;28;
100;13;287;319;32;29,3
100;13;319;350;31;
100;13;350;379;29;
100;13;379;408;29;
100;13;408;439;31;
100;13;439;468;29;
100;13;468;496;28;
100;13;496;523;27;
100;13;523;552;29;
100;13;552;580;28;
100;14;580;610;30;32,6
100;14;610;641;31;
100;14;641;672;31;
100;14;672;704;32;
100;14;704;735;31;
100;14;735;768;33;
100;14;768;802;34;
100;14;802;837;35;
100;14;837;873;36;
100;14;873;906;33;
100;15;906;937;31;35,1
100;15;937;972;35;
100;15;972;1005;33;
100;15;1005;1039;34;
100;15;1039;1074;35;
100;15;1074;1112;38;
100;15;1112;1149;37;
100;15;1149;1185;36;
100;15;1185;1222;37;
100;15;1222;1257;35;
100;16;1257;1291;34;36,1
100;16;1291;1323;32;
100;16;1323;1356;33;
100;16;1356;1392;36;
100;16;1392;1429;37;
100;16;1429;1467;38;
100;16;1467;1506;39;
100;16;1506;1543;37;
100;16;1543;1579;36;
100;16;1579;1618;39;
100;17;1618;1652;34;38
100;17;1652;1692;40;
100;17;1692;1730;38;
100;17;1730;1767;37;
100;17;1767;1806;39;
100;17;1806;1844;38;
100;17;1844;1881;37;
100;17;1881;1919;38;
100;17;1919;1958;39;
100;17;1958;1998;40;
100;18;270;310;40;40,6
100;18;310;354;44;
100;18;354;390;36;
100;18;390;431;41;
100;18;431;473;42;
100;18;473;513;40;
100;18;513;554;41;
100;18;554;595;41;
100;18;595;635;40;
100;18;635;676;41;
100;19;676;721;45;42,5
100;19;721;761;40;
100;19;761;806;45;
100;19;806;848;42;
100;19;848;891;43;
100;19;891;932;41;
100;19;932;972;40;
100;19;972;1014;42;
100;19;1014;1057;43;
100;19;1057;1101;44;
100;20;1101;1147;46;46,5
100;20;1147;1192;45;
100;20;1192;1240;48;
100;20;1240;1285;45;
100;20;1285;1331;46;
100;20;1331;1378;47;
100;20;1378;1425;47;
100;20;1425;1473;48;
100;20;1473;1521;48;
100;20;1521;1566;45;
100;21;1566;1613;47;48,3
100;21;1613;1657;44;
100;21;1657;1708;51;
100;21;1708;1756;48;
100;21;1756;1805;49;
100;21;1805;1855;50;
100;21;1855;1903;48;
100;21;256;305;49;
100;21;305;353;48;
100;21;353;402;49;
100;22;402;453;51;50,6
100;22;453;505;52;
100;22;505;557;52;
100;22;557;606;49;
100;22;606;657;51;
100;22;657;707;50;
100;22;707;759;52;
100;22;759;809;50;
100;22;809;858;49;
100;22;858;908;50;
100;23;908;960;52;53
100;23;960;1013;53;
100;23;1013;1065;52;
100;23;1065;1119;54;
100;23;1119;1173;54;
100;23;1173;1228;55;
100;23;1228;1283;55;
100;23;1283;1335;52;
100;23;1335;1388;53;
100;23;1388;1438;50;
100;24;1438;1495;57;55,1
100;24;1495;1549;54;
100;24;1549;1601;52;
100;24;1601;1656;55;
100;24;1656;1711;55;
100;24;1711;1767;56;
100;24;1767;1824;57;
100;24;1824;1880;56;
100;24;1880;1935;55;
100;24;276;330;54;
100;25;330;389;59;57,6
100;25;389;446;57;
100;25;446;500;54;
100;25;500;558;58;
100;25;558;617;59;
100;25;617;677;60;
100;25;677;736;59;
100;25;736;793;57;
100;25;793;849;56;
100;25;849;906;57;
100;26;906;965;59;59,8
100;26;965;1025;60;
100;26;1025;1086;61;
100;26;1086;1148;62;
100;26;1148;1207;59;
100;26;1207;1265;58;
100;26;1265;1324;59;
100;26;1324;1383;59;
100;26;1383;1443;60;
100;26;1443;1504;61;
100;27;1504;1566;62;62,4
100;27;1566;1629;63;
100;27;1629;1693;64;
100;27;1693;1756;63;
100;27;1756;1816;60;
100;27;1816;1877;61;
100;27;1877;1939;62;
100;27;287;349;62;
100;27;349;412;63;
100;27;412;476;64;
100;28;476;541;65;64,9
100;28;541;607;66;
100;28;607;674;67;
100;28;674;738;64;
100;28;738;801;63;
100;28;801;865;64;
100;28;865;930;65;
100;28;930;997;67;
100;28;997;1061;64;
100;28;1061;1125;64;
100;29;1125;1192;67;67,4
100;29;1192;1260;68;
100;29;1260;1329;69;
100;29;1329;1394;65;
100;29;1394;1460;66;
100;29;1460;1527;67;
100;29;1527;1595;68;
100;29;1595;1664;69;
100;29;1664;1732;68;
100;29;1732;1799;67;
100;30;1799;1868;69;69,7
100;30;1868;1938;70;
100;30;289;361;72;
100;30;361;430;69;
100;30;430;500;70;
100;30;500;571;71;
100;30;571;640;69;
100;30;640;708;68;
100;30;708;777;69;
100;30;777;847;70;
100;31;847;922;75;71,9
100;31;922;992;70;
100;31;992;1065;73;
100;31;1065;1133;68;
100;31;1133;1205;72;
100;31;1205;1281;76;
100;31;1281;1357;76;
100;31;1357;1430;73;
100;31;1430;1497;67;
100;31;1497;1566;69;
100;32;1566;1644;78;75,7
100;32;1644;1718;74;
100;32;1718;1792;74;
100;32;1792;1868;76;
100;32;1868;1942;74;
100;32;276;347;71;
100;32;347;425;78;
100;32;425;504;79;
100;32;504;580;76;
100;32;580;657;77;
100;33;657;740;83;80
100;33;740;814;74;
100;33;814;897;83;
100;33;897;976;79;
100;33;976;1059;83;
100;33;1059;1139;80;
100;33;1139;1218;79;
100;33;1218;1301;83;
100;33;1301;1378;77;
100;33;1378;1457;79;
100;34;1457;1536;79;82,3
100;34;1536;1622;86;
100;34;1622;1706;84;
100;34;1706;1789;83;
100;34;1789;1876;87;
100;34;1876;1956;80;
100;34;265;350;85;
100;34;350;428;78;
100;34;428;507;79;
100;34;507;589;82;
100;35;589;669;80;84,5
100;35;669;751;82;
100;35;751;835;84;
100;35;835;916;81;
100;35;916;1004;88;
100;35;1004;1093;89;
100;35;1093;1182;89;
100;35;1182;1268;86;
100;35;1268;1348;80;
100;35;1348;1434;86;
100;36;1434;1521;87;86,7
100;36;1521;1608;87;
100;36;1608;1697;89;
100;36;1697;1782;85;
100;36;1782;1868;86;
100;36;1868;1959;91;
100;36;257;339;82;
100;36;339;425;86;
100;36;425;508;83;
100;36;508;599;91;
100;37;599;686;87;86,9
100;37;686;771;85;
100;37;771;857;86;
100;37;857;944;87;
100;37;944;1032;88;
100;37;1032;1118;86;
100;37;1118;1208;90;
100;37;1208;1294;86;
100;37;1294;1383;89;
100;37;1383;1468;85;
100;38;1468;1558;90;89,8
100;38;1558;1650;92;
100;38;1650;1735;85;
100;38;1735;1825;90;
100;38;1825;1917;92;
100;38;256;349;93;
100;38;349;438;89;
100;38;438;526;88;
100;38;526;616;90;
100;38;616;705;89;
100;39;705;802;97;93,5
100;39;802;895;93;
100;39;895;989;94;
100;39;989;1078;89;
100;39;1078;1168;90;
100;39;1168;1257;89;
100;39;1257;1350;93;
100;39;1350;1446;96;
100;39;1446;1543;97;
100;39;1543;1640;97;
100;40;1640;1738;98;96,3
100;40;1738;1837;99;
100;40;1837;1931;94;
100;40;289;384;95;
100;40;384;479;95;
100;40;479;578;99;
100;40;578;676;98;
100;40;676;773;97;
100;40;773;866;93;
100;40;866;961;95;
100;41;961;1057;96;97,9
100;41;1057;1154;97;
100;41;1154;1256;102;
100;41;1256;1350;94;
100;41;1350;1444;94;
100;41;1444;1546;102;
100;41;1546;1647;101;
100;41;1647;1743;96;
100;41;1743;1841;98;
100;41;1841;1940;99;
100;42;350;454;104;102,5
100;42;454;551;97;
100;42;551;654;103;
100;42;654;759;105;
100;42;759;860;101;
100;42;860;962;102;
100;42;962;1067;105;
100;42;1067;1165;98;
100;42;1165;1270;105;
100;42;1270;1375;105;
100;43;1375;1481;106;102,8
100;43;1481;1582;101;
100;43;1582;1686;104;
100;43;1686;1788;102;
100;43;1788;1893;105;
100;43;1893;1995;102;
100;43;301;404;103;
100;43;404;505;101;
100;43;505;607;102;
100;43;607;709;102;
100;44;709;819;110;104,8
100;44;819;924;105;
100;44;924;1027;103;
100;44;1027;1132;105;
100;44;1132;1237;105;
100;44;1237;1339;102;
100;44;1339;1444;105;
100;44;1444;1547;103;
100;44;1547;1649;102;
100;44;1649;1757;108;
100;45;1757;1865;108;106,6
100;45;1865;1970;105;
100;45;256;366;110;
100;45;366;470;104;
100;45;470;575;105;
100;45;575;682;107;
100;45;682;785;103;
100;45;785;892;107;
100;45;892;1002;110;
100;45;1002;1109;107;
100;46;1109;1216;107;108
100;46;1216;1329;113;
100;46;1329;1433;104;
100;46;1433;1542;109;
100;46;1542;1648;106;
100;46;1648;1761;113;
100;46;1761;1872;111;
100;46;1872;1978;106;
100;46;267;374;107;
100;46;374;478;104;
100;47;478;588;110;109,1
100;47;588;696;108;
100;47;696;807;111;
100;47;807;913;106;
100;47;913;1027;114;
100;47;1027;1138;111;
100;47;1138;1245;107;
100;47;1245;1351;106;
100;47;1351;1462;111;
100;47;1462;1569;107;
100;48;1569;1680;111;112,3
100;48;1680;1796;116;
100;48;1796;1911;115;
100;48;278;392;114;
100;48;392;501;109;
100;48;501;617;116;
100;48;617;724;107;
100;48;724;831;107;
100;48;831;945;114;
100;48;945;1059;114;
100;49;1059;1172;113;114,6
100;49;1172;1285;113;
100;49;1285;1402;117;
100;49;1402;1512;110;
100;49;1512;1629;117;
100;49;1629;1748;119;
100;49;1748;1864;116;
100;49;1864;1977;113;
100;49;298;410;112;
100;49;410;526;116;
100;50;526;646;120;116,5
100;50;646;763;117;
100;50;763;878;115;
100;50;878;996;118;
100;50;996;1109;113;
100;50;1109;1228;119;
100;50;1228;1347;119;
100;50;1347;1460;113;
100;50;1460;1574;114;
100;50;1574;1691;117;
100;51;1691;1812;121;118,5
100;51;1812;1933;121;
100;51;254;369;115;
100;51;369;486;117;
100;51;486;607;121;
100;51;607;721;114;
100;51;721;835;114;
100;51;835;953;118;
100;51;953;1076;123;
100;51;1076;1197;121;
100;52;1197;1317;120;119,7
100;52;1317;1433;116;
100;52;1433;1551;118;
100;52;1551;1674;123;
100;52;1674;1793;119;
100;52;1793;1917;124;
100;52;255;377;122;
100;52;377;496;119;
100;52;496;616;120;
100;52;616;732;116;
100;53;732;855;123;123,2
100;53;855;982;127;
100;53;982;1106;124;
100;53;1106;1224;118;
100;53;1224;1343;119;
100;53;1343;1470;127;
100;53;1470;1596;126;
100;53;1596;1713;117;
100;53;1713;1838;125;
100;53;1838;1964;126;
100;54;267;393;126;125
100;54;393;515;122;
100;54;515;638;123;
100;54;638;763;125;
100;54;763;891;128;
100;54;891;1020;129;
100;54;1020;1147;127;
100;54;1147;1270;123;
100;54;1270;1393;123;
100;54;1393;1517;124;
100;55;1517;1641;124;125,8
100;55;1641;1773;132;
100;55;1773;1902;129;
100;55;278;406;128;
100;55;406;533;127;
100;55;533;657;124;
100;55;657;780;123;
100;55;780;903;123;
100;55;903;1027;124;
100;55;1027;1151;124;
100;56;1151;1282;131;127,7
100;56;1282;1409;127;
100;56;1409;1539;130;
100;56;1539;1664;125;
100;56;1664;1792;128;
100;56;1792;1918;126;
100;56;245;375;130;
100;56;375;507;132;
100;56;507;631;124;
100;56;631;755;124;
100;57;755;882;127;131,3
100;57;882;1013;131;
100;57;1013;1143;130;
100;57;1143;1275;132;
100;57;1275;1408;133;
100;57;1408;1542;134;
100;57;1542;1673;131;
100;57;1673;1807;134;
100;57;1807;1935;128;
100;57;256;389;133;
100;58;389;524;135;132,5
100;58;524;657;133;
100;58;657;788;131;
100;58;788;925;137;
100;58;925;1054;129;
100;58;1054;1185;131;
100;58;1185;1316;131;
100;58;1316;1448;132;
100;58;1448;1582;134;
100;58;1582;1714;132;
100;59;1714;1852;138;135,7
100;59;1852;1991;139;
100;59;278;417;139;
100;59;417;556;139;
100;59;556;687;131;
100;59;687;824;137;
100;59;824;957;133;
100;59;957;1089;132;
100;59;1089;1221;132;
100;59;1221;1358;137;
100;60;1358;1497;139;138
100;60;1497;1632;135;
100;60;1632;1775;143;
100;60;1775;1915;140;
100;60;290;430;140;
100;60;430;569;139;
100;60;569;705;136;
100;60;705;838;133;
100;60;838;980;142;
100;60;980;1113;133;
